Name	Gender
Aaron_Eckhart	male
Aaron_Guiel	male
Aaron_Patterson	male
Aaron_Peirsol	male
Aaron_Pena	male
Aaron_Sorkin	male
Aaron_Tippin	male
Abbas_Kiarostami	male
Abba_Eban	male
Abdel_Aziz_Al-Hakim	male
Abdel_Madi_Shabneh	male
Abdel_Nasser_Assidi	male
Abdoulaye_Wade	male
Abdulaziz_Kamilov	male
Abdullah	male
Abdullah_Ahmad_Badawi	male
Abdullah_al-Attiyah	male
Abdullah_Gul	male
Abdullah_Nasseef	male
Abdullatif_Sener	male
Abdul_Majeed_Shobokshi	male
Abdul_Rahman	male
Abel_Aguilar	male
Abel_Pacheco	male
Abid_Hamid_Mahmud_Al-Tikriti	male
Abner_Martinez	male
Abraham_Foxman	male
Aby_Har-Even	male
Adam_Ant	male
Adam_Freier	male
Adam_Herbert	male
Adam_Kennedy	male
Adam_Mair	male
Adam_Rich	male
Adam_Sandler	male
Adam_Scott	male
Adelina_Avila	male
Adel_Al-Jubeir	male
Adisai_Bodharamik	male
Adolfo_Aguilar_Zinser	male
Adolfo_Rodriguez_Saa	male
Adoor_Gopalakarishnan	male
Adriana_Lima	female
Adriana_Perez_Navarro	female
Adrianna_Zuzic	female
Adrian_Annus	male
Adrian_Fernandez	male
Adrian_McPherson	male
Adrian_Murrell	male
Adrian_Nastase	male
Adrien_Brody	male
Afton_Smith	female
Agbani_Darego	female
Agnelo_Queiroz	male
Agnes_Bruckner	female
Ahmad_Jbarah	male
Ahmad_Masood	male
Ahmed_Ahmed	male
Ahmed_Chalabi	male
Ahmed_Ghazi	male
Ahmed_Ibrahim_Bilal	male
Ahmed_Lopez	male
Ahmed_Qureia	male
Ahmet_Demir	male
Ahmet_Necdet_Sezer	male
Aicha_El_Ouafi	male
Aidan_Quinn	male
Aileen_Riggin_Soule	male
Ainsworth_Dyer	male
Ain_Seppik	male
Aishwarya_Rai	female
Aitor_Gonzalez	male
Aiysha_Smith	female
Ai_Sugiyama	female
Ajit_Agarkar	male
AJ_Cook	female
AJ_Lamas	male
Akbar_Al_Baker	male
Akbar_Hashemi_Rafsanjani	male
Akhmed_Zakayev	male
Akiko_Morigami	female
Akmal_Taher	male
Alain_Cervantes	male
Alain_Ducasse	male
Alanis_Morissette	female
Alanna_Ubach	female
Alan_Ball	male
Alan_Dershowitz	male
Alan_Dreher	male
Alan_Greenspan	male
Alan_Greer	male
Alan_Jackson	male
Alan_Mulally	male
Alan_Stonecipher	male
Alan_Tang_Kwong-wing	male
Alan_Trammell	male
Alan_Zemaitis	male
Alastair_Campbell	male
Alastair_Johnston	male
Albaro_Recoba	male
Alberta_Lee	female
Alberto_Acosta	male
Alberto_Fujimori	male
Alberto_Gonzales	male
Alberto_Ruiz_Gallardon	male
Alberto_Sordi	male
Albert_Brooks	female
Albert_Costa	male
Albert_Montanes	male
Albert_Pujols	male
Albrecht_Mentz	male
Aldo_Paredes	male
Alecos_Markides	male
Alec_Baldwin	male
Alejandro_Atchugarry	male
Alejandro_Avila	male
Alejandro_Fernandez	male
Alejandro_Gonzalez_Inarritu	male
Alejandro_Lembo	male
Alejandro_Lerner	male
Alejandro_Lopez	male
Alejandro_Toledo	male
Aleksander_Kwasniewski	male
Aleksander_Voloshin	male
Alek_Wek	female
Alessandra_Cerna	female
Alessandro_Nesta	male
Alexander_Downer	male
Alexander_Losyukov	male
Alexander_Lukashenko	male
Alexander_Payne	male
Alexander_Rumyantsev	male
Alexandra_Jackson	female
Alexandra_Pelosi	female
Alexandra_Rozovskaya	female
Alexandra_Spann	female
Alexandra_Stevenson	female
Alexandra_Vodjanikova	female
Alexandre_Daigle	male
Alexandre_Despatie	male
Alexandre_Herchcovitch	male
Alexandre_Vinokourov	male
Alexa_Loren	female
Alexa_Vega	female
Alexis_Bledel	female
Alexis_Dennisoff	male
Alex_Barros	male
Alex_Cabrera	male
Alex_Cejka	male
Alex_Corretja	male
Alex_Ferguson	male
Alex_Gonzalez	male
Alex_Holmes	male
Alex_King	male
Alex_Penelas	male
Alex_Popov	male
Alex_Sink	female
Alex_Wallau	male
Alex_Zanardi	male
Alfonso_Cuaron	male
Alfonso_Portillo	male
Alfonso_Soriano	male
Alfredo_di_Stefano	male
Alfredo_Moreno	male
Alfredo_Pena	male
Alfred_Ford	male
Alfred_Sant	male
Alice_Fisher	female
Alicia_Hollowell	female
Alicia_Keys	female
Alicia_Molik	female
Alicia_Silverstone	female
Alicia_Witt	female
Alimzhan_Tokhtakhounov	male
Alina_Kabaeva	female
Aline_Chretien	female
Alisha_Richman	female
Alison_Krauss	female
Alison_Lohman	female
Alistair_MacDonald	male
Ali_Abbas	female
Ali_Abdullah_Saleh	male
Ali_Adbul_Karim_Madani	male
Ali_Ahmeti	male
Ali_Bin_Hussein	male
Ali_Fallahian	male
Ali_Hammoud	male
Ali_Khamenei	male
Ali_Mohammed_Maher	male
Ali_Naimi	male
Allan_Houston	male
Allan_Kemakeza	male
Allan_Wagner	male
Allen_Iverson	male
Allen_Rock	male
Allison_Janney	female
Allison_Searing	male
Allyson_Felix	female
Ally_Sheedy	female
Alma_Powell	female
Almeida_Baptista	male
Alonzo_Mourning	male
Alvaro_Noboa	male
Alvaro_Silva_Calderon	male
Alvaro_Uribe	male
Alyse_Beaupre	female
Alyson_Hannigan	female
Aly_Wagner	female
Al_Cardenas	male
Al_Davis	male
Al_Gore	male
Al_Leiter	male
Al_Pacino	male
Al_Sharpton	male
Amanda_Beard	female
Amanda_Bynes	female
Amanda_Coetzer	female
Amanda_Marsh	female
Amanda_Plumer	female
Amber_Frey	female
Amber_Tamblyn	female
Ambrose_Lee	male
Amelia_Vega	female
Amelie_Mauresmo	male
Amer_al-Saadi	male
Amporn_Falise	female
Amram_Mitzna	male
Amr_Moussa	male
Amy_Brenneman	female
Amy_Cotton	female
Amy_Gale	female
Amy_Pascal	female
Amy_Redford	female
Amy_Smart	female
Amy_Yasbeck	female
Anastasia_Kelesidou	female
Anastasia_Myskina	female
Anatoliy_Kinakh	male
Ana_Claudia_Talancon	female
Ana_Guevara	female
Ana_Isabel_Sanchez	female
Ana_Palacio	female
Ana_Paula_Gerard	female
Ana_Sebastiao	female
Anderson_Varejao	male
Anders_Ebbeson	male
Anders_Fogh_Rasmussen	male
Andreas_Vinciguerra	male
Andrea_Bocelli	male
Andrea_De_Cruz	female
Andrea_Kiser	female
Andrea_Yates	female
Andrei_Konchalovsky	male
Andrei_Mikhnevich	male
Andrei_Nikolishin	male
Andres_DAlessandro	male
Andres_Manuel_Lopez_Obrador	male
Andres_Pastrana	male
Andrew_Bernard	male
Andrew_Bunner	male
Andrew_Caldecott	male
Andrew_Cuomo	male
Andrew_Fastow	male
Andrew_Firestone	male
Andrew_Gilligan	male
Andrew_Jarecki	male
Andrew_Luster	male
Andrew_Niccol	male
Andrew_Sabey	male
Andrew_Shutley	male
Andrew_Weissmann	male
Andrew_Wetzler	male
Andre_Agassi	male
Andre_Bucher	male
Andre_Lange	male
Andre_Smith	male
Andre_Techine	male
Andrzej_Tyszkiewicz	male
Andy_Benes	male
Andy_Bryant	male
Andy_Dick	male
Andy_Garcia	male
Andy_Graves	male
Andy_Griffith	male
Andy_Griggs	male
Andy_Hebb	male
Andy_Lau	male
Andy_Madikians	male
Andy_North	male
Andy_Perez	male
Andy_Roddick	male
Andy_Rooney	male
Andy_Warhol	male
Andy_Wisecarver	male
Anette_Hosoi	female
AnFernce_Negron	female
Angela_Alvarado_Rosa	female
Angela_Bassett	female
Angela_Lansbury	female
Angela_Mascia-Frye	female
Angela_Merkel	female
Angelica_Romero	female
Angelina_Jolie	female
Angelo_Genova	male
Angelo_Reyes	male
Angel_Lockward	male
Angel_Maza	male
Angie_Arzola	female
Angie_Martinez	female
Anibal_Ibarra	male
Anil_Ramsook	male
Anita_DeFrantz	male
Anja_Paerson	female
Anjum_Hussain	male
Anna_Chicherova	female
Anna_Faris	female
Anna_Jones	female
Anna_Kournikova	female
Anna_Nicole_Smith	female
Anneli_Jaatteenmaki	female
Annette_Bening	female
Annette_Lu	female
Anne_Cavers	female
Anne_Donovan	female
Anne_Heche	female
Anne_Krueger	female
Anne_McLellan	female
Anne_ONeil	female
Annie-Jeanne_Reynaud	female
Annie_Chaplin	female
Annie_Machon	female
Annika_Sorenstam	female
Ann_Godbehere	female
Ann_Landers	female
Ann_Morgan	female
Ann_Veneman	female
Antanas_Valionis	male
Anthony_Carter	male
Anthony_Corso	male
Anthony_Ervin	male
Anthony_Fauci	male
Anthony_Garotinho	male
Anthony_Hazen	male
Anthony_Hopkins	male
Anthony_LaPaglia	male
Anthony_Lee_Johnson	male
Anthony_Mazur	male
Anthony_Pico	male
Anthony_Pisciotti	male
Anthony_Principi	male
Anthony_Rackauckas	male
Anthony_Scott_Miller	male
Antje_Buschschulte	female
Antonio_Banderas	male
Antonio_Bernardo	male
Antonio_Cassano	male
Antonio_Catania	male
Antonio_Elias_Saca	male
Antonio_Palocci	male
Antonio_Trillanes	male
Antony_Leung	male
Anton_Balasingham	male
Antwun_Echols	male
Anwar_Ibrahim	male
Anzori_Kikalishvili	male
Aparna_Pillai	female
Aram_Adler	male
Arantxa_Sanchez-Vicario	male
Aretha_Franklin	female
Arianna_Huffington	female
Ariel_Sharon	male
Arie_Haan	male
Arif_Mardin	male
Ari_Bousbib	male
Ari_Fleischer	male
Arlen_Specter	male
Armando_Avila_Panchame	male
Armando_Calderon_Sol	male
Armando_Carrillo	male
Armand_Sargen	male
Arminio_Fraga	male
Arnaud_Clement	male
Arnaud_Lagardere	male
Arnie_Boehm	male
Arnoldo_Aleman	male
Arnold_Palmer	male
Arnold_Schwarzenegger	male
Arnold_Scott	male
Aron_Ralston	male
Arsinee_Khanjian	female
Arthur_Johnson	male
Arthur_Martinez	male
Artieas_Shanks	male
Arturo_Gatti	male
Art_Cooper	male
Art_Hoffmann	male
Art_Howe	male
Art_Lopez	male
Arye_Mekel	male
Asa_Hutchinson	male
Ascencion_Barajas	male
Ashanti	female
Ashlea_Talbot	female
Ashley_Judd	female
Ashley_Olsen	female
Ashley_Postell	female
Ashraf_Alasmar	male
Ashraf_Ghani	male
Ashton_Kutcher	male
Asif_Ali_Zardari	female
Asif_Hanif	male
Askar_Akayev	male
Asmaa_Assad	female
Assad_Ahmadi	male
Astou_Ndiaye-Diatta	female
Astrid_Betancourt	female
Astrid_Eyzaguirre	female
Atal_Bihari_Vajpayee	male
Ataollah_Mohajerani	male
Atiabet_Ijan_Amabel	female
Atom_Egoyan	male
Atsushi_Sato	male
Audrey_Lacroix	female
Audrey_Sauret	female
Augustin_Calleri	male
Augusto_Pinochet	male
Augusto_Roa_Bastos	male
Aung_San_Suu_Kyi	male
Austin_Kearns	male
Avril_Lavigne	female
Azmi_Bishara	male
Azra_Akin	female
Babe_Ruth	male
Baburam_Bhattari	male
Bak_Chang-Ryun	male
Barbara_Bach	female
Barbara_Becker	female
Barbara_Bodine	female
Barbara_Boxer	female
Barbara_Brezigar	female
Barbara_De_Brun	female
Barbara_Esbin	female
Barbara_Felt-Miller	female
Barbara_Roberts	female
Barbara_Walters	female
Barbora_Strycova	female
Barbra_Streisand	female
Barrett_Jackman	male
Barry_Alvarez	male
Barry_Bonds	male
Barry_Collier	male
Barry_Diller	male
Barry_Ford	male
Barry_Hinson	male
Barry_Nakell	male
Barry_Switzer	male
Barry_Williams	male
Barry_Zito	male
Bartosz_Kizierowski	male
Bart_Freundlich	male
Bart_Hendricks	male
Barzan_al-Tikriti	male
Basdeo_Panday	male
Bashar_Assad	male
Baz_Luhrmann	male
BB_King	male
Beatrice_Dalle	female
Beatriz_Merino	female
Beecher_Ray_Kirby	male
Begum_Khaleda_Zia	female
Bela_Karolyi	male
Benazir_Bhutto	female
Benedita_da_Silva	female
Benicio_Del_Toro	male
Benito_Santiago	male
Benjamin_Bratt	male
Benjamin_Franklin	male
Benjamin_Martinez	male
Benjamin_McKenzie	female
Benjamin_Netanyahu	male
Benjamin_Neulander	male
Ben_Affleck	male
Ben_Betts	male
Ben_Braun	male
Ben_Broussard	male
Ben_Cahoon	male
Ben_Chandler	male
Ben_Cohen	male
Ben_Curtis	male
Ben_Davis	male
Ben_Glisan	male
Ben_Howland	male
Ben_Kingsley	male
Ben_Lee	male
Ben_Stein	male
Ben_Wallace	male
Bernadette_Peters	female
Bernardo_Segura	male
Bernard_Ebbers	male
Bernard_Giraudeau	male
Bernard_Kerik	male
Bernard_Landry	male
Bernard_Law	male
Bernard_Lord	male
Bernard_Siegel	male
Bernice_Wong	female
Bertie_Ahern	male
Bertrand_Bonello	male
Bertrand_Delanoe	male
Beth_Blough	female
Beth_Jones	female
Betsy_Coffin	female
Betsy_Smith	female
Bettina_Rheims	female
Betty_Garrison	female
Betty_Williams	female
Beyonce_Knowles	female
Bianca_Jagger	female
Bijan_Darvish	male
Bijan_Namdar_Zangeneh	male
Bilal_Erdogan	male
Biljana_Plavsic	female
Billy_Andrade	male
Billy_Beane	male
Billy_Bob_Thornton	male
Billy_Boyd	male
Billy_Crawford	male
Billy_Crystal	male
Billy_Donovan	male
Billy_Edelin	male
Billy_Gilman	male
Billy_Graham	male
Billy_Joel	male
Billy_Rork	male
Billy_Sollie	male
Billy_Tibbets	male
Bill_Belichick	male
Bill_Bradley	male
Bill_Butler	male
Bill_Byrne	male
Bill_Callahan	male
Bill_Carmody	male
Bill_Cartwright	male
Bill_Clancy	male
Bill_Clinton	male
Bill_Curry	male
Bill_Doba	male
Bill_Duffey	male
Bill_Elliott	male
Bill_Fennelly	male
Bill_Frist	male
Bill_Gates	male
Bill_Graham	male
Bill_Guerin	male
Bill_Herrion	male
Bill_Hughes	male
Bill_King	male
Bill_Kollar	male
Bill_Kong	male
Bill_Lerach	male
Bill_Maher	male
Bill_Mauldin	male
Bill_McBride	male
Bill_Nelson	male
Bill_OReilly	male
Bill_Parcells	male
Bill_Parsons	male
Bill_Paxton	male
Bill_Pryor	male
Bill_Rainer	male
Bill_Readdy	male
Bill_Richardson	male
Bill_Self	male
Bill_Simon	male
Bill_Sizemore	male
Bill_Stapleton	male
Bill_Stein	male
Bill_Walton	male
Bing_Crosby	male
Binyamin_Ben-Eliezer	male
Bison_Dele	male
Bixente_LIzarazu	male
BJ_Habibie	male
Blas_Ople	male
Blythe_Danner	female
Blythe_Hartley	female
Bobby_Bowden	male
Bobby_Goldwater	male
Bobby_Jackson	male
Bobby_Kielty	male
Bobby_Robson	male
Bobo_Balde	male
Bob_Alper	male
Bob_Beauprez	male
Bob_Bowlsby	male
Bob_Cantrell	male
Bob_Colvin	male
Bob_Crippen	male
Bob_Curtis	male
Bob_Dole	male
Bob_Eskridge	male
Bob_Ferguson	male
Bob_Geldof	male
Bob_Goldman	male
Bob_Graham	male
Bob_Guccione	male
Bob_Hartley	male
Bob_Hayes	male
Bob_Herz	male
Bob_Holden	male
Bob_Hope	male
Bob_Huggins	male
Bob_Iger	male
Bob_Krueger	male
Bob_Melvin	male
Bob_Menendez	male
Bob_Newhart	male
Bob_Petrino	male
Bob_Riley	male
Bob_Stoops	male
Bob_Sulkin	male
Bob_Taft	male
Bob_Wright	male
Bode_Miller	male
Bonnie_Fuller	female
Bonnie_Hunt	female
Bono	male
Boris_Becker	male
Boris_Berezovsky	male
Boris_Henry	male
Boris_Jordan	male
Boris_Trajkovski	male
Boris_Yeltsin	male
Boutros_Boutros_Ghali	male
Bo_Pelini	male
Bo_Ryan	male
Brady_Rodgers	male
Brad_Alexander_Smith	male
Brad_Banks	male
Brad_Brownell	male
Brad_Garrett	male
Brad_Gushue	male
Brad_Johnson	male
Brad_Miller	male
Brad_Pitt	male
Brad_Russ	male
Brad_Smith	male
Brad_Wilk	male
Brajesh_Mishra	male
Brandon_Boyd	male
Brandon_Fails	male
Brandon_Hammond	male
Brandon_Inge	male
Brandon_Jones	male
Brandon_Knight	male
Brandon_Larson	male
Brandon_Lloyd	male
Brandon_Robinson	male
Brandon_Spann	male
Brandon_Webb	male
Branko_Crvenkovski	male
Brawley_King	male
Brendan_Fraser	male
Brendan_Gaughan	male
Brendan_Hansen	male
Brendan_Stai	male
Brenda_Magana	female
Brenda_van_Dam	female
Brenda_Wilson	female
Brennon_Leighton	male
Brent_Coles	male
Brett_Boone	male
Brett_Hawke	male
Brett_Hull	male
Brett_Perry	male
Brian_Billick	male
Brian_Campbell	male
Brian_Cashman	male
Brian_Clemens	male
Brian_Cook	male
Brian_Cowen	male
Brian_De_Palma	male
Brian_Florence	male
Brian_Grazier	male
Brian_Gregory	male
Brian_Griese	male
Brian_Heidik	male
Brian_Henson	male
Brian_Jordan	male
Brian_Kerr	male
Brian_Lara	male
Brian_McIntyre	male
Brian_Meadors	male
Brian_Mulroney	male
Brian_Olson	male
Brian_Pavlich	male
Brian_Scalabrine	male
Brian_Schneider	male
Brian_StPierre	male
Brian_Van_Dusen	male
Brian_Weaver	male
Brian_Wells	male
Brian_Williams	male
Bridgette_Wilson-Sampras	female
Bridget_Fonda	female
Brigitte_Boisselier	female
Britney_Spears	female
Brittany_Snow	female
Brock_Berlin	male
Bronson_Arroyo	female
Brooke_Adams	female
Brooke_Gordon	female
Brooke_Shields	female
Brook_Robinson	male
Bruce_Arena	male
Bruce_Gebhardt	male
Bruce_Lunsford	male
Bruce_Paltrow	male
Bruce_Springsteen	male
Bruce_Van_De_Velde	male
Bruce_Weber	male
Bruce_Willis	male
Bruna_Colosio	male
Bruno_Junquiera	male
Bryant_Young	male
Bryan_Adams	male
Bryan_Chui	male
Bryan_Cooley	male
Bryan_Murray	male
Bryan_Thomas	male
Bryce_Carmine	male
Buck_Rodgers	male
Buddy_Ryan	male
Budd_Schulberg	male
Bud_Selig	male
Buford_Blount	male
Bulent_Ecevit	male
Bustam_A_Zedan_Aljanabi	male
Butch_Davis	male
Buzz_Hargrove	male
Byron_Scott	male
Cabas	male
Caio_Blat	male
Calbert_Cheaney	male
Calista_Flockhart	female
Calvin_Harrison	male
Calvin_Joseph_Coleman	male
Cameron_Diaz	female
Camilla_Parker_Bowles	female
Camille_Colvin	female
Camille_Lewis	female
Camryn_Manheim	female
Candace_Sutton	male
Candice_Beatty	female
Candice_Bergen	female
Candie_Kung	female
Carey_Lowell	female
Carina_Lau_Ka-ling	female
Carin_Koch	female
Cari_Davis	female
Carla_Del_Ponte	female
Carla_Gay_Balingit	female
Carla_Gugino	female
Carla_Moreno	female
Carla_Myers	female
Carla_Sullivan	female
Carla_Tricoli	female
Carlos_Alberto	male
Carlos_Alberto_Parreira	male
Carlos_Arroyo	male
Carlos_Barra	male
Carlos_Barragan	male
Carlos_Beltran	male
Carlos_Bianchi	male
Carlos_De_Abreu	male
Carlos_Fasciolo	male
Carlos_Ghosn	male
Carlos_Iturgaitz	male
Carlos_Juarez	male
Carlos_Lordkipanitse	male
Carlos_Manuel_Pruneda	male
Carlos_Menem	male
Carlos_Mesa	male
Carlos_Moya	male
Carlos_Ortega	male
Carlos_Paternina	male
Carlos_Queiroz	male
Carlos_Quintanilla_Schmidt	male
Carlos_Ruckauf	male
Carlos_Ruiz	male
Carlos_Salinas	male
Carlos_Savedra	male
Carlos_Vives	male
Carlo_Ancelotti	male
Carlo_Azeglio_Ciampi	male
Carlton_Baugh	male
Carlton_Dotson	male
Carly_Fiorina	female
Carly_Gullickson	female
Carl_Levin	male
Carl_Pope	male
Carl_Reiner	male
Carmen_Electra	female
Carolina_Barco	female
Carolina_Kluft	female
Carolina_Moraes	female
Caroline_Dhavernas	female
Caroline_Kennedy	female
Caroline_Link	female
Carolyn_Dawn_Johnson	female
Carolyn_Kuhl	female
Carol_Burnett	female
Carol_Carmody	female
Carol_Moseley_Braun	female
Carol_Niedermayer	female
Carol_Williams	female
Carrie-Anne_Moss	female
Carroll_Weimer	male
Carson_Daly	male
Carson_Palmer	male
Casey_Crowder	female
Casey_Mears	male
Cassandra_Heise	female
Cass_Ballenger	male
Casy_Preslar	female
Cate_Blanchett	female
Catherine_Bell	female
Catherine_Deneuve	female
Catherine_Donkers	female
Catherine_Ndereba	female
Catherine_Woodard	female
Catherine_Zeta-Jones	female
Cathryn_Crawford	female
Cathy_Chisholm	female
Cathy_Cunningham	female
Cathy_Freeman	female
Catriona_Le_May_Doan	female
Cecile_de_France	female
Cecilia_Bolocco	female
Cecilia_Chang	female
Cecilia_Cheung	female
Cedric_Benson	male
Celia_Cruz	female
Celine_Dion	female
Celso_Amorim	male
Celso_Lafer	male
Cemil_Cicek	male
Cesar_Gaviria	male
Cesar_Maia	male
Chadha_Gurinder	female
Chakib_Khelil	male
Chance_Mock	male
Chanda_Rubin	female
Chandrika_Kumaratunga	female
Chang_Dae-whan	male
Chang_Jae_On	male
Chang_Saio-yue	female
Chang_Sang	female
Chang_Tso	male
Chante_Jawan_Mallard	female
Chan_Choi	male
Chan_Gailey	male
Chan_Ho_Park	male
Charla_Moye	female
Charlene_Barshefsky	female
Charles_Bell	male
Charles_Bronson	male
Charles_Chandler_IV	male
Charles_Cope	male
Charles_Grassley	male
Charles_Holzner	male
Charles_Ingram	male
Charles_Kartman	male
Charles_Lebois	male
Charles_Mathews	male
Charles_Moose	male
Charles_Pickering	male
Charles_Pouty	male
Charles_Richardson	male
Charles_Rogers	male
Charles_Schumer	male
Charles_Tannok	male
Charles_Taylor	male
Charley_Armey	male
Charlie_Coles	male
Charlie_Deane	male
Charlie_Garner	male
Charlie_Hunnam	male
Charlie_Sheen	male
Charlie_Williams	male
Charlie_Zaa	male
Charlize_Theron	female
Charlotte_Casiraghi	female
Charlotte_Chambers	male
Charlotte_Church	female
Charlotte_Rampling	female
Charlton_Heston	male
Charmaine_Crooks	female
Chawki_Armali	male
Cha_Yung-gu	male
Chea_Sophara	male
Chelsea_Clinton	female
Chen_Kaige	male
Chen_Liang_Yu	male
Chen_Shui-bian	male
Chen_Tsai-chin	male
Cherie_Blair	female
Cherry_Jones	female
Cheryl_Ford	male
Cheryl_Hines	female
Cheryl_James	female
Cheryl_Little	female
Cheryl_Tiegs	female
Chhouk_Rin	male
Chick_Hearn	male
Chin-Feng_Chen	male
Chin-Hui_Tsao	male
Chip_Burrus	male
Chip_Ganassi	male
Chip_Knight	male
Chistian_Stahl	male
Chita_Rivera	female
Chloe_Sevigny	female
Choi_Sung-hong	male
Choi_Yun-yong	female
Chok_Tong_Goh	male
Cho_Myung-kyun	male
Christiane_Wulff	male
Christian_Bale	male
Christian_Fittipaldi	male
Christian_Gimenez	male
Christian_Lacroix	male
Christian_Lirette	male
Christian_Longo	male
Christian_Malcolm	male
Christian_Olsson	male
Christian_Patino	male
Christian_Von_Wernich	male
Christian_Wulff	male
Christina_Aguilera	female
Christina_Sawaya	female
Christine_Arron	female
Christine_Baumgartner	female
Christine_Ebersole	female
Christine_Gregoire	female
Christine_Rau	female
Christine_Todd_Whitman	female
Christopher_Amolsch	male
Christopher_Conyers	male
Christopher_Matero	male
Christopher_Patten	male
Christopher_Reeve	male
Christopher_Russell	male
Christopher_Speer	male
Christopher_Walken	male
Christopher_Whittle	male
Christoph_Daum	male
Christy_Ferer	female
Christy_Turlington	female
Chris_Andrews	male
Chris_Bell	male
Chris_Byrd	male
Chris_Cirino	male
Chris_Claiborne	male
Chris_Columbus	male
Chris_Cookson	male
Chris_Cooper	male
Chris_Cornell	male
Chris_Crocker	male
Chris_Dodd	male
Chris_Forsyth	male
Chris_Gratton	male
Chris_Hernandez	male
Chris_Klein	male
Chris_Kolanas	male
Chris_Matthews	male
Chris_Moore	male
Chris_Neil	male
Chris_Noth	male
Chris_Penn	male
Chris_Pronger	male
Chris_Reitsma	male
Chris_Rock	male
Chris_Simon	male
Chris_Swecker	male
Chris_Terry	male
Chris_Thomas	male
Chris_Tucker	male
Chris_Whitney	male
Chuanyun_Li	male
Chuck_Amato	male
Chuck_Bednarik	male
Chuck_Eidson	male
Chuck_Finley	male
Chuck_Hagel	male
Chuck_Woolery	male
Chuck_Yeager	male
Chung_Mong-hun	male
Chung_Mong-joon	male
Chyung_Dai-chul	male
Ciaran_Hinds	male
Cindy_Crawford	female
Cindy_Klassen	female
Cindy_Margolis	female
Cindy_Moll	female
Cindy_Taylor	female
Cindy_Zagorski	female
Ciro_Gomes	male
Claire_Danes	female
Claire_De_Gryse	female
Claire_Hentzen	female
Claire_Leger	female
Claire_Tomalin	female
Clara_Harris	female
Clare_Latimer	female
Clare_Short	female
Clark_Randt	male
Claudette_Robinson	female
Claude_Jorda	male
Claudia_Cardinale	female
Claudia_Coslovich	female
Claudia_Pechstein	female
Claudia_Schiffer	female
Claudine_Farrell	female
Claudio_Abbado	male
Claudio_Lopez	male
Claudio_Ranieri	male
Clay_Aiken	male
Clay_Campbell	male
Clemente_de_la_Vega	male
Clifford_Etienne	male
Clifford_Robinson	male
Cliff_Ellis	male
Clint_Eastwood	male
Clint_Howard	male
Clint_Lamebear	male
Clive_Lloyd	male
Clive_Woodward	male
Coco_dEste	female
Coleen_Rowley	female
Cole_Chapman	female
Colin_Campbell	male
Colin_Cowie	male
Colin_Farrell	male
Colin_Jackson	male
Colin_Montgomerie	male
Colin_Phillips	male
Colin_Powell	male
Colin_Prescot	male
Colleen_Atwood	female
Colleen_Donovan	female
Colleen_Jones	female
Colleen_OClair	female
Colleen_Ryan	female
Collis_Temple_III	male
Columba_Bush	female
Compay_Segundo	male
Conan_OBrien	male
Conchita_Martinez	female
Condoleezza_Rice	female
Connie_Chung	female
Connie_Freydell	male
Conrad_Black	male
Constance_Marie	male
Cora_Cambell	male
Coretta_Scott_King	female
Corey_Maggette	male
Corinna_Harfouch	female
Corinne_Coman	female
Cori_Enghusen	male
Corliss_Williamson	male
Cosmo_Iacavazzi	male
Costas_Simitis	male
Courtney_Cox	female
Courtney_Love	female
Craig_Burley	male
Craig_David	male
Craig_Doblin	male
Craig_Fitzgibbon	male
Craig_MacTavish	male
Craig_Morgan	male
Craig_OClair	male
Craig_Wilson	male
Crandall_Bowles	female
Crispin_Glover	male
Cristiano_da_Matta	male
Cristian_Barros	male
Cristina_Fernandez	female
Cristina_Kirchner	female
Cristina_Saralegui	female
Cristina_Torrens_Valero	male
Cruz_Bustamante	male
Cuba_Gooding_Jr	male
Curtis_Joseph	male
Curtis_Rodriguez	male
Curtis_Strange	male
Curt_Weldon	male
Cyndi_Thompson	female
Cynthia_Nixon	female
Cynthia_Rowley	female
Dagmar_Dunlevy	female
Daisy_Fuentes	female
Dai_Bachtiar	male
Dai_Chul_Chyung	male
Daja_Bedanova	male
Dalai_Lama	male
Dale_Bosworth	male
Dale_Earnhardt	male
Dale_Earnhardt_Jr	male
Dalia_Rabin-Pelosoff	female
Damarius_Bilbo	male
Damon_Dash	male
Damon_Stoudamire	male
Damon_van_Dam	male
Dana_Vollmer	male
DAngelo_Jimenez	male
Daniela_Cicarelli	female
Daniela_Hantuchova	female
Daniele_Bergamin	male
Daniele_Hypolito	male
Daniele_Nardello	male
Danielle_Spencer	female
Daniell_Sunjata	male
Daniel_Barenboim	male
Daniel_Bruehl	male
Daniel_Chin	male
Daniel_Coats	male
Daniel_Comisso_Urdaneta	male
Daniel_Darnell	male
Daniel_Day-Lewis	male
Daniel_Kurtzer	male
Daniel_Montenegro	male
Daniel_Montgomery	male
Daniel_Ortega	male
Daniel_Osorno	male
Daniel_Patrick_Moynihan	male
Daniel_Pearl	male
Daniel_Radcliffe	male
Daniel_Rouse	male
Daniel_Scioli	male
Daniel_Zelman	male
Danis_Tanovic	male
Danny_Ainge	male
Danny_Avalon	male
Danny_Elfman	male
Danny_Glover	male
Danny_Green	male
Danny_Morgan	male
Dany_Heatley	male
Dan_Ackroyd	male
Dan_Bartlett	male
Dan_Boyle	male
Dan_Bylsma	male
Dan_Dickau	male
Dan_Duquette	male
Dan_Guerrero	male
Dan_Kellner	male
Dan_LaCoutre	male
Dan_Monson	male
Dan_Morales	male
Dan_Prinster	male
Dan_Quayle	male
Dan_Reeves	male
Dan_Snyder	male
Dan_Wheldon	male
Darcy_Regier	male
Darin_Erstad	male
Dario_Camuffo	male
Dario_Franchitti	male
Dariusz_Michalczewski	male
Darko_Milicic	male
Darla_Moore	female
Darlene_Garrettson	male
Darrell_Dickey	male
Darrell_Issa	male
Darrell_Porter	male
Darrell_Royal	male
Darren_Campel	male
Darren_Clarke	male
Darryl_McDaniels	male
Darryl_Stingley	male
Darvis_Patton	male
Daryl_Hannah	female
Daryl_Jones	male
Daryl_Parks	male
Daryl_Sabara	male
Daryl_Smith	male
Davey_Johnson	male
Dave_Barr	male
Dave_Campo	male
Dave_Johnson	male
Dave_Lewis	male
Dave_Matthews	male
Dave_McGinnis	male
Dave_McNally	male
Dave_McNealey	male
Dave_Odom	male
Dave_Potter	male
Dave_Ragone	male
Dave_Robertson	male
Dave_Tucker	male
Dave_Wannstedt	male
Dave_Williams	male
David_Alpay	male
David_Anderson	male
David_Arquette	male
David_Ballantyne	male
David_Beckham	male
David_Bell	male
David_Bisbal	male
David_Blaine	male
David_Bowie	male
David_Braley	male
David_Brent	male
David_Brinkley	male
David_Brown	male
David_Canary	male
David_Caraway	male
David_Carradine	male
David_Caruso	male
David_Chase	male
David_Collenette	male
David_Coulthard	male
David_Dewayne_Williams	male
David_Dewhurst	male
David_Dodge	male
David_Donohue	male
David_Dorfman	male
David_Duke	male
David_Duval	male
David_Eldon	male
David_Gest	male
David_Glenn	male
David_Hannay	male
David_Hanson	male
David_Hasselhoff	male
David_Heyman	male
David_Heymann	male
David_Hilt	male
David_Ho	male
David_Howard	male
David_Hyde_Pierce	male
David_Kelley	male
David_Kelly	male
David_Leahy	male
David_McCallum	male
David_McCullough	male
David_McKiernan	male
David_Millar	male
David_Modell	male
David_Montoya	male
David_Myers	male
David_Nalbandian	male
David_Obey	male
David_Oh	male
David_Provost	male
David_Przybyszewski	male
David_Rivkin_Jr	male
David_Scott_Morris	male
David_Shayler	male
David_Sibleyk	male
David_Siegel	male
David_Sousa	male
David_Spade	male
David_Stern	male
David_Suazo	male
David_Surrett	male
David_Tornberg	male
David_Trimble	male
David_Welch	male
David_Wells	male
David_Westerfield	male
David_Wolf	male
David_Zeplowitz	male
Davis_Love_III	male
Dawna_LoPiccolo	female
Dawn_Staley	female
Dean_Barker	male
Dean_Barkley	male
Dean_Jacek	male
Dean_Sheremet	male
Debbie_Allen	female
Debbie_Reynolds	female
Debra_Brown	female
Debra_Messing	female
Debra_Rose	female
Debra_Shank	female
Debra_Yang	female
Deb_Santos	female
Deece_Eckstein	male
Deena_Burnett	female
Deepa_Mehta	female
Della_Clara	female
Delphine_Chuillot	female
Demetrin_Veal	male
Demetrius_Ferraciu	male
Demi_Moore	female
Denise_Johnson	female
Denise_Locke	female
Denise_van_Outen	female
Denis_Coderre	male
Denis_Fassou-Nguesso	male
Deniz_Baykal	male
Dennis_Archer	male
Dennis_Erickson	male
Dennis_Franchione	male
Dennis_Hastert	male
Dennis_Johnson	male
Dennis_Kozlowski	male
Dennis_Kucinich	male
Dennis_Miller	male
Dennis_Oswald	male
Dennis_Powell	male
Denys_Arcand	male
Denzel_Washington	male
Dereck_Whittenburg	male
Derek_Abney	male
Derek_Bond	male
Derek_Jeter	male
Derek_King	male
Derek_Lowe	male
Derek_Parra	male
Derian_Hatcher	male
Derrick_Battie	male
Derrick_Rodgers	male
Derrick_Taylor	male
Desiree_Lemosi	female
Desiree_McKenzie	female
Desmon_Farmer	male
Des_Brown	male
Devin_Harris	male
Dewayne_White	male
Dexter_Jackson	male
Diana_Krall	female
Diana_Munz	female
Diana_Renee_Valdivieso_Dubon	female
Diana_Ross	female
Diana_Silvius	female
Diana_Taurasi	female
Diana_Taylor	female
Diane_Green	female
Diane_Ladd	female
Diane_Lane	female
Dianne_Feinstein	female
Dianne_Reeves	female
Dick_Armey	male
Dick_Bennett	male
Dick_Cheney	male
Dick_Clark	male
Dick_Devine	male
Dick_Jauron	male
Dick_Latessa	male
Dick_Posthumus	male
Dick_Smothers	male
Dick_Vermeil	male
Didier_Defago	male
Diego_Armando_Maradona	male
Diego_Colorado	male
Diego_Diego_Lerman	male
Dieter_Holzer	male
Dieter_Zetsche	male
Dimitar_Berbatov	male
Dimitri_Perricos	male
Dinah_Turner	female
Dinora_Rosales	female
Dino_de_Laurentis	male
Dino_Risi	male
Din_Samsudin	male
Dionigi_Tettamanzi	male
Dionne_Warwick	female
Dionyssis_Georgiadis	male
Dion_Glover	male
Dirk_Kempthorne	male
Dita_Von_Tesse	female
Djabir_Said-Guerni	male
Doc_Rivers	male
Dolly_Parton	female
Dolma_Tsering	female
Dominick_Dunne	male
Dominic_Monaghan	male
Dominik_Garcia-Lorido	female
Dominik_Hrbaty	male
Dominique_de_Villepin	male
Dominique_Perben	male
Donald_Anderson	male
Donald_Carty	male
Donald_Evans	male
Donald_Fehr	male
Donald_Hays	male
Donald_Keck	male
Donald_Keyser	male
Donald_Pettit	male
Donald_Regan	male
Donald_Rumsfeld	male
Donald_Trump	male
Donatella_Versace	female
Donna_Barrera	female
Donna_Brazile	female
Donna_Morrissey	female
Donna_Ralston	female
Donna_Shalala	male
Donna_Walker	male
Donnie_Brennan	male
Donny_Osmond	male
Don_Boudria	male
Don_Carcieri	male
Don_Flanagan	male
Don_Henley	male
Don_Hewitt	male
Don_King	male
Don_Lake	male
Don_Matthews	male
Don_Meredith	male
Don_Nickles	male
Don_Siegelman	male
Dora_Bakoyianni	female
Doris_Roberts	female
Doris_Schroeder	female
Dorothy_Lamour	female
Dorothy_Loudon	female
Dorothy_Wilson	female
Dorthy_Moxley	female
Dot_Helms	female
Douglas_Faneuil	male
Douglas_Gansler	male
Douglas_Meester	male
Douglas_Paal	male
Doug_Christie	male
Doug_Collins	male
Doug_Duncan	male
Doug_Melvin	male
Doug_Moe	male
Doug_Racine	male
Doug_Wilson	male
Dragan_Covic	male
Drew_Barrymore	female
Drew_Bledsoe	male
Drew_Gooden	male
Duane_Barber	male
Duane_Lee_Chapman	male
Dudley_Rogers	male
Dule_Hill	male
Duncan_Fletcher	male
Dunn_Lampton	male
Dustan_Mohr	male
Dustin_Brown	male
Dustin_Hoffman	male
Dusty_Baker	male
Du_Qinglin	male
Dwain_Kyles	male
Dwayne_Johnson	male
Dwayne_Wade	male
Dwayne_Williams	male
Dyab_Abou_Jahjah	male
Dyana_Calub	male
Earl_Campbell	male
Earl_Counter	male
Earl_Fritts	male
Earl_Scruggs	male
Eddie_Compass	male
Eddie_Fenech_Adami	male
Eddie_Jordan	male
Eddie_Lewis	male
Eddie_Lucio	male
Eddie_Murray	male
Eddie_Sutton	male
Eddy_Hartenstein	male
Eddy_Merckx	male
Edgar_Savisaar	male
Edie_Falco	female
Edina_Batar	female
Edith_Masai	male
Edmund_Hillary	male
Edmund_Stoiber	male
Edouard_Michelin	male
Eduardo_Chillida	male
Eduardo_Duhalde	male
Eduardo_Fischer	male
Eduardo_Romero	male
Eduard_Limonov	male
Eduard_Shevardnadze	male
Edward_Albee	male
Edward_Arsenault	male
Edward_Belvin	male
Edward_Burns	male
Edward_Egan	male
Edward_Flynn	male
Edward_Greenspan	male
Edward_James_Olmos	male
Edward_Johnson	male
Edward_Kennedy	male
Edward_Lohn	male
Edward_Lu	male
Edward_Norton	male
Edward_Said	male
Edward_Seaga	male
Edwina_Currie	female
Edwin_Edwards	male
Ed_Book	male
Ed_Case	male
Ed_Mekertichian	male
Ed_Rendell	male
Ed_Rosenthal	male
Ed_Smart	male
Ed_Sullivan	male
Ed_Wade	male
Efrain_Rios_Montt	male
Eglis_Yaima_Cruz	male
Eileen_Coparropa	female
Eileen_Spina	male
Einars_Repse	male
Ekaterina_Dmitriev	male
Ekke_Hard_Forberg	male
Eladio_Larez	male
Elaine_Chao	female
Elaine_Stritch	female
Elena_Bereznaya	female
Elena_Bovina	female
Elena_Dementieva	female
Elena_de_Chavez	female
Elena_Likhovtseva	female
Elena_Tihomirova	female
Elgin_Baylor	male
Eliane_Karp	female
Elias_Attallah	male
Elijah_Wood	male
Elijan_Ingram	male
Elinor_Caplan	female
Elin_Nordegren	female
Eliott_Spitzer	male
Elisabeth_Schumacher	male
Elisabeth_Welch	female
Elisha_Cuthbert	female
Elizabeth_Berkeley	female
Elizabeth_Dole	female
Elizabeth_Hill	female
Elizabeth_Hurley	female
Elizabeth_Pena	female
Elizabeth_Regan	female
Elizabeth_Shue	female
Elizabeth_Smart	male
Elizabeth_Taylor	female
Eliza_Dushku	female
Eliza_Manningham-Buller	female
Eli_Broad	male
Eli_Rosenbaum	male
Eli_Stutsman	male
Ellen_Barkin	female
Ellen_DeGeneres	female
Ellen_Engleman	female
Ellen_MacArthur	female
Ellen_Martin	female
Ellen_Pompeo	female
Ellen_Saracini	female
Elliott_Mincberg	male
Elmar_Brok	male
Elodie_Bouchez	female
Eloy_Gutierrez	male
Elsa_Zylberstein	female
Elton_John	male
Elva_Hsiao	female
Elvis_Costello	male
Elvis_Presley	male
Elvis_Stojko	male
El_Hadji_Diouf	male
Emanuel_Ginobili	male
Emelie_Loit	female
Emile_Lahoud	male
Emilio_Azcarraga_Jean	male
Emilio_Botin	male
Emily_Mason	female
Emily_Mortimer	female
Emily_Robison	female
Emily_Stevens	female
Eminem	male
Emmanuelle_Beart	female
Emmanuelle_Jagodsinski	female
Emmanuel_Filiberto	male
Emmanuel_Milingo	male
Emma_Nicholson	female
Emma_Thompson	female
Emma_Watson	female
Emmit_Smith	male
Emmy_Rossum	female
Emyr_Jones_Parry	male
Enola_Rice	female
Enos_Slaughter	male
Enrica_Fico	female
Enrik_Vendt	male
Enrique_Bolanos	male
Enrique_Haroldo_Gorriaran_Merlo	male
Enrique_Iglesias	male
Enrique_Medina_Gomez	male
Enrique_Oliu	male
Erick_Barkley	male
Eric_Bana	male
Eric_Benet	male
Eric_Christian_Olsen	male
Eric_Clapton	male
Eric_Daze	male
Eric_Dubin	male
Eric_Fehr	male
Eric_Hinske	male
Eric_Idle	male
Eric_Lindros	male
Eric_Lloyd	female
Eric_Robert_Rudolph	male
Eric_Rosser	male
Eric_Ryan_Donnelly	male
Eric_Schacht	male
Eric_Shinseki	male
Eric_Snow	male
Eric_Staal	male
Eric_Taino	male
Eric_Vigouroux	male
Eric_Wedge	male
Erika_Christensen	female
Erika_Harold	female
Erika_Reyes	male
Eriko_Tamura	female
Erik_Morales	male
Erin_Brockovich	female
Erin_Hershey_Presley	female
Erin_Runnion	female
Ernesto_Zedillo	male
Ernest_Hollings	male
Ernie_Els	male
Ernie_Eves	male
Ernie_Fletcher	male
Ernie_Grunfeld	male
Ernie_Harwell	male
Ernie_Preate	male
Ernie_Stewart	male
Erskine_Bowles	male
Erwin_Abdullah	male
Erwin_Mapasseng	male
Esad_Landzo	male
Esteban_Cordoba-Velazquez	male
Estella_Warren	female
Estelle_Morris	male
Ester_Canadas	female
Esther_Macklin	female
Ethan_Hawke	male
Etta_James	female
Eugene_Melnyk	male
Eugene_Teslovic	male
Eunice_Barber	female
Eurico_Guterres	male
Evander_Holyfield	male
Evan_Marriott	male
Evan_Rachel_Wood	female
Eva_Amurri	female
Eva_Dimas	female
Eva_Herzigova	female
Eva_Marie_Saint	female
Eva_Mendes	female
Evelyn_Lauder	female
Eve_Ensler	female
Eve_Pelletier	female
Evgeni_Plushenko	male
Evie_Lazarou	female
Evo_Morales	male
Ewan_McGregor	male
E_Clay_Shaw	male
Fabian_Vargas	male
Fabiola_Zuluaga	female
Fabrice_Santoro	male
Fabricio_Oberto	male
Faisal_Iqbal	male
Faisal_Saleh_Hayat	male
Fann_Wong	female
Farida_Ragoonanan	female
Farouk_al-Sharaa	male
Farouk_Kaddoumi	male
Fatma_Kusibeh	female
Fatmir_Limaj	male
Faye_Alibocus	female
Faye_Dunaway	female
Faye_Wong	female
Fayssal_Mekdad	male
Fazal-ur-Rehman	male
Federico_Castelan_Sayre	male
Federico_Fellini	male
Federico_Trillo	male
Feliciano_Lopez	male
Felicity_Huffman	female
Felipe_De_Borbon	male
Felipe_Fernandez	male
Felipe_Perez_Roque	male
Felix_Doh	male
Felix_Mantilla	male
Felix_Sanchez	male
Felix_Trinidad	male
Ferenc_Madl	male
Fernando_Alonso	male
Fernando_Gonzalez	male
Fernando_Henrique_Cardoso	male
Fernando_Hierro	male
Fernando_Leon_de_Aranoa	male
Fernando_Sanz	male
Fernando_Valenzuela	male
Fernando_Vargas	male
Fernando_Velardez	male
Festus_Mogae	male
Fidel_Castro	male
Fidel_Castro_Daiz-Balart	male
Filippo_Inzaghi	male
Filippo_Volandri	male
Filip_De_Winter	male
Fiona_Milne	female
Flavia_Delaroli	female
Flavia_Pennetta	female
Florecita_Cobian	female
Florencia_Kirchner	female
Florencia_Macri	female
Flor_Montulo	female
Floyd_Keith	male
Floyd_Mayweather	male
Francesco_Totti	female
Frances_Fisher	male
Francisco_Flores	male
Francisco_Garcia	male
Francisco_Maturana	male
Francisco_Santos	male
Francisco_Urenda	male
Francis_Collins	male
Francis_Crick	male
Francis_Ford_Coppola	male
Francis_George	male
Francis_Mer	male
Francis_Ricciardone	male
Franck_Cerutti	male
Francois_Botha	male
Francois_Ozon	male
Francois_Pienaar	male
Franco_Cangele	male
Franco_Dragone	male
Franco_Frattini	male
Franklin_Brown	male
Franklin_Damann	male
Franko_Simatovic	male
Frank_Abagnale_Jr	male
Frank_Beamer	male
Frank_Bell	male
Frank_Cassell	male
Frank_Coraci	male
Frank_Dunham_Jr	male
Frank_Griswold	male
Frank_Hilldrup	male
Frank_Hsieh	male
Frank_Keating	male
Frank_Lautenberg	male
Frank_Marshall	male
Frank_Murkowski	male
Frank_Pallone	male
Frank_Schmoekel	male
Frank_Shea	male
Frank_Sinatra	male
Frank_Solich	male
Frank_Stallone	male
Frank_Taylor	male
Frank_Van_Ecke	male
Frank_Wycheck	male
Frank_Zappa	male
Franz_Beckenbauer	male
Franz_Fischler	male
Franz_Gsell	male
Franz_Muentefering	male
Fran_Drescher	female
Freda_Black	male
Freddy_Garcia	male
Freddy_Vasques_Kinchokpe	male
Frederick_Madden	male
Frederique_van_der_Wal	female
Fredric_Seaman	male
Fred_Durst	male
Fred_Eckhard	male
Fred_Funk	male
Fred_Huff	male
Fred_Rogers	male
Fred_Swan	male
Fred_Thompson	male
Fred_Wilpon	male
Fruit_Chan	male
Fujio_Cho	male
Fujio_Mitarai	male
Gabi_Zimmer	female
Gabriella_Bo	female
Gabrielle_Rose	female
Gabrielle_Union	female
Gabriel_Batistuta	male
Gabriel_Farhi	male
Gabriel_Hughes	male
Gabriel_Jorge_Ferreia	male
Gabriel_Valdes	male
Gael_Garcia_Bermal	male
Gala_Leon_Garcia	male
Galen_Rowell	male
Gao_Qiang	male
Garry_Alejano	male
Garry_Kasparov	male
Garry_McCoy	male
Garry_Trudeau	male
Garry_Witherall	male
Garth_Drabinsky	male
Gary_Bald	male
Gary_Barnett	male
Gary_Bauer	male
Gary_Bergeron	male
Gary_Bettman	male
Gary_Carter	male
Gary_Coleman	male
Gary_Condit	male
Gary_Dellaverson	male
Gary_Doer	male
Gary_Forsee	male
Gary_Gero	male
Gary_Gitnick	male
Gary_Leon_Ridgway	male
Gary_Locke	male
Gary_Marshall	male
Gary_Paer	male
Gary_Sayler	male
Gary_Sinise	male
Gary_Stevens	male
Gary_Williams	male
Gary_Winnick	male
Gaston_Gaudio	male
Gavin_Degraw	female
Gavyn_Arthur	male
Gavyn_Davies	male
Gene_Autry	male
Gene_Hackman	male
Gene_Keady	male
Gene_Orza	male
Gene_Robinson	male
Gene_Sauers	male
Gennifer_Flowers	female
Geno_Auriemma	male
Gen_Meredith	male
Geoffrey_Davis	male
Geoffrey_Rush	male
Geoff_Dixon	male
Geoff_Hoon	male
George_Allen	male
George_Blaney	male
George_Bovell	male
George_Brumley	male
George_Brumley_III	male
George_Clooney	male
George_Foreman	male
George_Galloway	male
George_Gregan	male
George_Harrison	male
George_HW_Bush	male
George_Karl	male
George_Lopez	male
George_Lucas	male
George_Maxwell_Richards	male
George_McCloud	male
George_Murphy	male
George_Papandreou	male
George_Pataki	male
George_Plimpton	male
George_P_Bush	male
George_Robertson	male
George_Roy_Hill	male
George_Ryan	male
George_Tenet	male
George_Voinovich	male
George_W_Bush	male
Georgia_Giddings	female
Georgina_Bardach	female
Georgina_Papin	female
Georgi_Parvanov	male
Geovani_Lapentti	male
Geraldine_Chaplin	female
Geraldo_Rivera	male
Gerald_Barbarito	male
Gerald_Calabrese	male
Gerald_Fitch	male
Gerald_Ford	male
Gerald_Riley	male
Gerardo_Gambala	male
Gerard_Butler	male
Gerard_Depardieu	male
Gerard_de_Cortanze	male
Gerard_Kleisterlee	male
Gerard_Tronche	male
Gerhard_Boekel	male
Gerhard_Schmid	male
Gerhard_Schroeder	male
German_Khan	male
Gerrit_Zalm	male
Gerry_Adams	male
Gerry_Kelly	male
Gerry_Parsky	male
Ghassan_Elashi	male
Gholamreza_Aghazadeh	male
Giancarlo_Fisichella	male
Gianna_Angelopoulos-Daskalaki	female
Giannina_Facio	female
Gianni_Agnelli	male
Gian_Marco	male
Gideon_Black	male
Gideon_Yago	male
Gilberto_Rodriguez_Orejuela	male
Gilberto_Simoni	male
Gilles_Panizzi	male
Gillian_Anderson	female
Gil_Cates	male
Gil_de_Ferran	male
Gina_Centrello	female
Gina_Gershon	female
Gina_Lollobrigida	female
Gina_Torres	female
Giovanny_Cordoba	male
Gisele_Bundchen	female
Giselle_Estefania_Tavarelli	female
Giulietta_Masina	female
Giulio_Andreotti	male
Giuseppe_Gibilisco	male
Giuseppe_Morchio	male
Glafcos_Clerides	male
Glenn_Plummer	male
Glenn_Rivers	male
Glenn_Tilton	male
Glen_Clark	male
Glen_DaSilva	male
Glen_Sather	male
Gloria_Allred	female
Gloria_Gaynor	female
Gloria_Macapagal_Arroyo	female
Gloria_Trevi	female
GL_Peiris	male
Goh_Kun	male
Goldie_Hawn	female
Gong_Li	female
Gong_Ruina	female
Gonzalo_Barrientos	male
Gonzalo_Sanchez_de_Lozada	male
Goran_Persson	male
Goran_Zivkovic	male
Gordana_Grubin	male
Gorden_Tallis	male
Gordon_Brown	male
Gordon_Campbell	male
Gordon_Cooper	male
Gordon_Lightfoot	male
Gordon_McDonald	male
Gore_Verbinski	male
Gore_Vidal	male
Grace_Brinell	female
Grace_Dodd	female
Grace_Kelly	female
Graciano_Rocchigiani	male
Gracia_Burnham	male
Grady_Irvin_Jr	male
Grady_Little	male
Graeme_Lloyd	male
Graeme_Smith	male
Graham_Bentley	male
Grant_Hackett	male
Grant_Rossenmeyer	female
Gray_Davis	male
Gregg_Berhalter	male
Gregg_Popovich	male
Gregorio_Honasan	male
Gregorio_Rosal	male
Gregory_Geoffroy	male
Gregory_Hines	male
Gregory_Peck	male
Gregor_Gysi	male
Greg_Frers	male
Greg_Gilbert	male
Greg_Hennigar	male
Greg_Hodge	male
Greg_Kinnear	male
Greg_Kinsey	male
Greg_Ostertag	male
Greg_Owen	male
Greg_Rusedski	male
Gretchen_Mol	female
Griffin_Colvin	female
Gro_Harlem_Brundtland	female
Guangdong_Ou_Guangyuan	male
Guennadi_Chipouline	male
Guenter_Verheugen	male
Guido_Westerwelle	male
Guillaume_Cannet	male
Guillaume_Depardieu	male
Guillaume_Soro	male
Guillermo_Canas	male
Guillermo_Coria	male
Guillermo_Monroy	male
Guillermo_Ortiz	male
Guillermo_Ruiz_Polanco	male
Gunilla_Backman	female
Gunter_Pleuger	male
Gustavo_Cisneros	male
Gustavo_Franco	male
Gustavo_Kuerten	male
Gustavo_Noboa	male
Gustavo_Terrazas	male
Gus_Frerotte	male
Gus_Van_Sant	male
Guus_Hiddink	male
Guy_Hemmings	male
Guy_Ritchie	male
Guy_Verhofstadt	male
Gwendal_Peizerat	female
Gwen_Stefani	female
Gwyneth_Paltrow	female
Habib_Hisham	male
Habib_Rizieq	male
Hadley_Bilger	female
Halbert_Fillinger	male
Halle_Berry	female
Hal_Gehman	male
Hal_McCoy	male
Hal_Sellers	male
Hal_Sutton	male
Hamad_Bin_Isa_al-Khalifa	male
Hamad_Bin_Jassim	male
Hama_Arba_Diallo	male
Hamid_Efendi	male
Hamid_Karzai	male
Hamid_Reza_Asefi	male
Hamzah_Haz	male
Hamza_Atiya_Muhsen	male
Ham_Pong-sil	female
Hanan_Ashrawi	female
Hana_Makhmalbaf	female
Hana_Sadiq	female
Hana_Urushima	female
Hank_Aaron	male
Hank_Azaria	male
Hank_Bass	male
Hank_McKinnell	male
Hank_Stram	male
Hannah_Stockbauer	female
Hanns_Schumacher	male
Hans-Christian_Schmid	male
Hans_Blix	male
Hans_Corell	male
Hans_Eichel	male
Hans_Leistritz	male
Hans_Peter_Briegel	male
Han_Sung_Joo	male
Harald_Ringstorff	male
Harbhajan_Singh	male
Harland_Braun	male
Harold_Brown	male
Harold_Scott	male
Harriet_Lessy	female
Harrison_Ford	male
Harry_Belafonte	male
Harry_Kalas	male
Harry_Schmidt	male
Hartmut_Mehdorn	male
Harvey_Fierstein	male
Harvey_Wachsman	male
Harvey_Weinstein	male
Hasan_Wirayuda	male
Hashan_Tillakaratne	male
Hashim_Thaci	male
Hassanal_Bolkiah	male
Hassan_Nasrallah	male
Hassan_Wirajuda	male
Hatsui_Hasuike	female
Haydar_Aliyev	male
Hayden_Panettiere	female
Hayley_Tullett	female
Heather_Chinnock	female
Heather_Locklear	female
Heather_Mills	female
Heather_Whitestone_McCallum	female
Heather_Willson	female
Heath_Ledger	male
Hector_Babenco	male
Hector_Grullon	male
Hector_Mitelman	male
Hedayat_Amin_Arsala	male
Hee-Won_Han	male
Heidi_Fleiss	female
Heidi_Klum	female
Heinrich_Wolfgang	male
Heinz_Feldmann	male
Heizo_Takenaka	male
Helena_Schneider	female
Helene_Eksterowicz	female
Helen_Alvare	female
Helen_Clark	female
Helen_Darling	female
Helio_Castroneves	male
Helio_Rubens_Garcia	male
Helmut_Panke	male
Helo_Pinheiro	female
Henk_Bekedam	male
Henning_Scherf	male
Henrique_Meirelles	male
Henri_Proglio	male
Henry_Castellanos	male
Henry_Hilow	male
Henry_Hyde	male
Henry_Kissinger	male
Henry_Suazo	male
Herbert_Haupt	male
Herbie_Hancock	male
Herb_Brooks	male
Herb_Dhaliwal	male
Herb_Ritts	male
Herb_Sendek	male
Hermando_Harton	male
Hermann_Maier	male
Herman_Edwards	male
Herman_Moore	male
Hermes_Gamonal	male
Hermogenes_Ebdane_Jr	male
Hernan_Crespo	male
Hernan_Diaz	male
Herta_Daeubler-Gmelin	female
Hestrie_Cloette	male
Hichiro_Naemura	male
Hideki_Matsui	male
Hideki_Sato	male
Hidetoshi_Nakata	male
Hikmat_al-Azzawi	male
Hilary_Duff	female
Hilary_McKay	female
Hilda_Fortune	female
Hillary_Clinton	female
Hilmi_Akin_Zorlu	male
Hilmi_Ozkok	male
Himmler_Rebu	male
Hipolito_Mejia	male
Hiroki_Gomi	male
Hiroyuki_Yoshino	male
Hisao_Oguchi	male
Hisashi_Owada	male
Hisham_Halawi	male
Hitomi_Soga	female
Hitoshi_Oshitani	male
Hitoshi_Tanaka	male
Hoda_Asfor	female
Holly_Hunter	female
Holly_Robinson_Peete	female
Hong_Myung	male
Hootie_Johnson	male
Horace_Donovan_Reid	male
Horace_Newcomb	male
Horacio_de_Jesus_Montoya	male
Horacio_Julio_Pina	male
Horst_Koehler	male
Hosni_Mubarak	male
Howard_Dean	male
Howard_Ross	male
Howard_Schultz	male
Howard_Smith	male
Howard_Stern	male
Howard_Stringer	male
Howard_Wilkinson	male
Hrithik_Roshan	male
Huang_Suey-Sheng	male
Huan_Chung_Yi	male
Hubert_Green	male
Hubie_Brown	male
Hugh_Campbell	male
Hugh_Carey	male
Hugh_Grant	male
Hugh_Hefner	male
Hugh_Jessiman	male
Hugh_Miller	male
Hugo_Chavez	male
Hugo_Colace	male
Hugo_Conte	male
Humberto_Coelho	male
Humberto_Espinoza	male
Hung_Wan-ting	female
Hunter_Bates	male
Hunter_Kemper	male
Hun_Sen	male
Hushiar_Zebari	male
Hussam_Mohammed_Amin	male
Hussein_Malik	male
Hutomo_Mandala_Putra	male
Hu_Jintao	male
Hu_Maoyuan	male
Hwang_Doo-yun	male
Iain_Anderson	male
Iain_Duncan_Smith	male
Iain_Richmond	male
Ian_Campbell	male
Ian_Gillan	male
Ian_Huntley	male
Ian_Knop	male
Ian_McKellen	male
Ian_Moran	male
Ian_Smith	male
Ian_Thorpe	male
Ian_Wilmut	male
Iban_Mayo	male
Ibrahim_Al-Marashi	male
Ibrahim_Haddad	male
Ibrahim_Hilal	male
Ibrahim_Jaafari	male
Ibrahim_Rugova	male
Idi_Amin	male
Ignacio_Antonio_Velasco	male
Ignatius_Wang	male
Igor_Ivanov	male
Igor_Trunov	male
Ilan_Goldfajn	male
Ilan_Ramon	male
Ilham_Aliev	male
Ilie_Nastase	male
Imad_Khadduri	male
Imad_Moustapha	male
Imam_Samudra	male
Imelda_Marcos	female
Imran_Khan	male
Imre_Kertasz	male
Inam-ul-Haq	male
Infanta_Cristina	female
Inga_Hall	female
Ingrid_Betancourt	female
Inocencio_Arias	male
Intisar_Ajouri	female
Ion_Iliescu	male
Ion_Tiriac	male
Iran_Brown	male
Ira_Einhorn	male
Irene_Kahn	male
Irfan_Ahmed	male
Irina_Framtsova	female
Irina_Lobacheva	female
Irina_Yatchenko	female
Irv_Nathan	male
Irwan_Fadzi_Idris	male
Isabela_Moraes	male
Isabella_Rossellini	female
Isabelle_Huppert	female
Isabel_Orellana	male
Isaiah_Washington	male
Ishaq_Shahryar	male
Isidro_Pastor	male
Islam_Karimov	male
Ismael_Miranda	male
Ismail_Abu_Shanab	male
Ismail_Cem	male
Ismail_Khan	male
Ismail_Merchant	male
Itamar_Franco	male
Itzhak_Perlman	male
Ivana_Trump	female
Ivan_Helguera	male
Ivan_Lee	male
Ivan_Shvedoff	male
Ivan_Stambolic	male
Iva_Majoli	male
Iveta_Benesova	female
Ivo_Dubs	male
Izzat_Ibrahim	male
Jaap_de_Hoop_Scheffer	male
Jackie_Chan	male
Jackie_Dennis	female
Jackie_Sherrill	male
Jacky_Cheung	male
Jack_Goodman	female
Jack_Grubman	male
Jack_Knowlton	male
Jack_LaLanne	male
Jack_Nicholson	male
Jack_Osbourne	male
Jack_Smith	male
Jack_Straw	male
Jack_Valenti	male
Jack_Welch	male
Jacob_Frenkel	male
Jacqueline_Edwards	male
Jacqueline_Gold	female
Jacqueline_Marris	female
Jacqueline_Obradors	female
Jacques_Chirac	male
Jacques_Kallis	male
Jacques_Rogge	male
Jacques_Villeneuve	male
Jada_Pinkett_Smith	female
Jade_Jagger	female
Jafar_Umar_Thalib	male
Jaime_Orti	male
Jaime_Pressly	female
Jake_Brace	male
Jake_Gyllenhaal	male
Jake_Plummer	male
Jakob_Kellenberger	male
Jalal_Talabani	male
Jalen_Rose	male
James_Baker	male
James_Ballenger	male
James_Barksdale	male
James_Becker	male
James_Blake	male
James_Brazelton	male
James_Brosnahan	male
James_Brown	male
James_Butts	male
James_Caan	male
James_Cameron	male
James_Carville	male
James_Coburn	male
James_Collinson	male
James_Comey	male
James_Coviello	male
James_Cunningham	male
James_Dingemans	male
James_Franco	male
James_Gandolfini	male
James_Gibson	male
James_Hakett	male
James_Hallock	male
James_Harris	male
James_Hill	male
James_Hoffa	male
James_Hughes	male
James_Ivory	male
James_Jones	male
James_Kelly	male
James_Kirtley	male
James_Kopp	male
James_Layug	male
James_Lockhart	male
James_Maguire	male
James_Mathis	male
James_May	male
James_McGreevey	male
James_McMahon	male
James_McPherson	male
James_Meeks	male
James_Meredeth	male
James_Morris	male
James_Murdoch	male
James_Parker	male
James_Phelps	male
James_Roberts	male
James_Robertson_Jr	male
James_Schultz	male
James_Sensenbrenner	male
James_Smith	male
James_Spalding	male
James_Traficant	male
James_Wallack	male
James_Watt	male
James_Wattana	male
James_Williams	male
James_Wolfensohn	male
James_W_Kennedy	male
James_Young	male
Jamie_Carey	female
Jamie_Cooke	male
Jamie_Dimon	male
Jamie_Kellner	male
Jamie_King	female
Jamie_Lee_Curtis	male
Jamie_Martin	male
Jamie_Olis	male
Jamie_Villafane	male
Jamir_Miller	male
Jamling_Norgay	male
Jan-Michael_Gambill	male
Jana_Henke	male
Jana_Pittman	female
Janela_Jara	male
Janette_Husarova	female
Janet_Chandler	female
Janet_Crawford	female
Janet_Ecker	female
Janet_Horvath	female
Janet_Leigh	female
Janet_Napolitano	female
Janet_Thorpe	female
Janez_Drnovsek	male
Jane_Clayson	female
Jane_Fonda	female
Jane_Kaczmarek	female
Jane_Krakowski	female
Jane_Leeves	female
Jane_Menelaus	female
Jane_Pauley	female
Jane_Riley	female
Jane_Rooney	female
Jane_Russell	female
Jane_Walker_Wood	female
Janica_Kostelic	female
Janice_Abreu	female
Janice_Goldfinger	female
Janine_Pietsch	female
Janis_Ruth_Coulter	female
Janusz_Kaminski	male
Jan_Bjoerklund	male
Jan_De_Bont	male
Jan_Paul_Miller	male
Jan_Petersen	male
Jan_Peter_Balkenende	male
Jan_Pronk	male
Jan_Ullrich	male
Jan_van_Breda_Kolff	male
Jaouad_Gharib	male
Jaqueline_Godoy	male
Jaromir_Jagr	male
Jason_Alexander	male
Jason_Bentley	male
Jason_Biggs	male
Jason_Campbell	male
Jason_Clermont	male
Jason_Gardner	male
Jason_Jennings	male
Jason_Kapono	male
Jason_Keep	male
Jason_Kidd	male
Jason_Lezak	male
Jason_Mewes	male
Jason_Petty	male
Jason_Priestley	male
Jason_Sehorn	male
Jason_Sorens	male
Jason_Statham	male
Jason_Vale	male
Jason_White	male
Javier_Bardem	male
Javier_Camara	male
Javier_Delgado	male
Javier_Saviola	male
Javier_Solana	male
Javier_Vargas	male
Javier_Vazquez	male
Javier_Weber	male
Javier_Zanetti	male
Jawad_Boulus	male
Jaymon_Crabb	male
Jayne_Yarris	male
Jayson_Williams	male
Jay_Garner	male
Jay_Leno	male
Jay_Rasulo	male
JC_Chasez	male
Jean-Claude_Braquet	male
Jean-Claude_Juncker	male
Jean-Claude_Trichet	male
Jean-Claude_Van_Damme	male
Jean-David_Levitte	male
Jean-Francois_Lemounier	male
Jean-Francois_Pontal	male
Jean-Luc_Bideau	male
Jean-Marc_de_La_Sabliere	male
Jean-Marc_Olive	male
Jean-Patrick_Nazon	male
Jean-Pierre_Bemba	male
Jean-Pierre_Raffarin	male
Jean-Rene_Fourtou	male
Jean-Sebastien_Giguere	male
Jeanette_Gray	female
Jeanette_Stauffer	female
Jeane_Kirkpatrick	female
Jeannette_Biedermann	female
Jeanne_Anne_Schroeder	female
Jeanne_Moreau	female
Jean_Brumley	female
Jean_Carnahan	female
Jean_Charest	male
Jean_Chretien	male
Jean_Nagel	female
Jean_Todt	male
Jeb_Bush	male
Jefferson_Perez	male
Jeffery_Hendren	male
Jeffery_Strelzin	male
Jeffrey_Archer	male
Jeffrey_Ashby	male
Jeffrey_Donaldson	male
Jeffrey_Immelt	male
Jeffrey_Jones	male
Jeffrey_Katzenberg	male
Jeffrey_Pfeffer	male
Jeffrey_Scott_Postell	male
Jeff_Bridges	male
Jeff_Bzdelik	male
Jeff_Dederian	male
Jeff_Feldman	male
Jeff_George	male
Jeff_Hornacek	male
Jeff_Roehm	male
Jeff_Schiffner	male
Jeff_Van_Gundy	male
Jeff_Weaver	male
Jelena_Dokic	female
Jenna_Elfman	female
Jennette_Bradley	female
Jennie_Finch	female
Jennie_Garth	female
Jennifer_Aniston	female
Jennifer_Capriati	female
Jennifer_Connelly	female
Jennifer_Furminger	female
Jennifer_Garner	female
Jennifer_Granholm	female
Jennifer_Gratz	female
Jennifer_Keller	female
Jennifer_Lopez	female
Jennifer_Love_Hewitt	female
Jennifer_McCoy	female
Jennifer_Murray	female
Jennifer_Pena	female
Jennifer_Reilly	female
Jennifer_Renee_Short	female
Jennifer_Rodriguez	female
Jennifer_Thompson	female
Jennifer_Tilly	female
Jenny_Romero	female
Jens_Lehmann	male
Jen_Bice	female
Jen_Schefft	female
Jeong_Se-hyun	male
Jerelle_Kraus	female
Jeremy_Fogel	male
Jeremy_Gompertz	male
Jeremy_Greenstock	male
Jeremy_Shockey	male
Jeremy_Wotherspoon	male
Jeri_Ryan	female
Jerome_Golmard	male
Jerome_Jenkins	male
Jerry_Angelo	male
Jerry_Bruckheimer	male
Jerry_Colangelo	male
Jerry_Falwell	male
Jerry_Hall	female
Jerry_Jones	male
Jerry_Lewis	male
Jerry_McEntee	male
Jerry_Oliver	male
Jerry_Pauley	male
Jerry_Regier	male
Jerry_Rice	male
Jerry_Seinfeld	male
Jerry_Sexton	male
Jerry_Sloan	male
Jerry_Springer	male
Jerry_Tarkanian	male
Jesper_Parnevik	male
Jesse_Harris	male
Jesse_Helms	male
Jesse_Jackson	male
Jesse_James	male
Jesse_James_Leija	male
Jesse_Ventura	male
Jessica_Alba	female
Jessica_Biel	female
Jessica_Brungo	female
Jessica_Capshaw	female
Jessica_Lange	female
Jessica_Lynch	female
Jessica_Simpson	female
Jesus_Cardenal	male
Jewel_Howard-Taylor	female
Jiang_Zemin	male
Jia_Qinglin	male
Jimmy_Carter	male
Jimmy_Gobble	male
Jimmy_Gurule	male
Jimmy_Iovine	male
Jimmy_Jimenez	male
Jimmy_Kimmel	male
Jimmy_Lee	male
Jimmy_Smits	male
Jimmy_Szymanski	male
Jim_Abbott	male
Jim_Ahern	male
Jim_Anderson	male
Jim_Beattie	male
Jim_Bollman	male
Jim_Bunning	male
Jim_Calhoun	male
Jim_Cantalupo	male
Jim_Carrey	male
Jim_Doyle	male
Jim_Edmonds	male
Jim_Fassel	male
Jim_Flaherty	male
Jim_Freudenberg	male
Jim_Furyk	male
Jim_Greenwood	male
Jim_Hahn	male
Jim_Hardin	male
Jim_Harrick	male
Jim_Haslett	male
Jim_Hendry	male
Jim_Jeffords	male
Jim_Kelly	male
Jim_Leach	male
Jim_Letten	male
Jim_Nochols	male
Jim_OBrien	male
Jim_Otto	male
Jim_Parque	male
Jim_Paxson	male
Jim_Piper	male
Jim_Ryan	male
Jim_Schwarz	male
Jim_Spinoza	male
Jim_Sterk	male
Jim_Talent	male
Jim_Taylor	male
Jim_Thome	male
Jim_Tressel	male
Jim_Wall	male
Jim_Wessling	male
Jim_Wong	male
Jim_Zorn	male
Jiri_Novak	male
JJ_Redick	male
JK_Rowling	female
Joanna_Poitier	female
Joanne_Duquette	female
Joanne_Woodward	female
Joan_Claybrook	female
Joan_Collins	female
Joan_Dangerfield	female
Joan_Jett	female
Joan_Laporta	male
Joao_Rocha	male
Joaquim_Levy	male
Joaquim_Rodriguez	male
Joaquin_Phoenix	male
Joaquin_Sanchez	male
Job_Cohen	male
Jodie_Foster	female
Jodie_Henry	female
Jodie_Kidd	female
Jody_Richards	male
Joel_Gallen	male
Joel_Todd	female
Joerg_Haider	male
Joey_Buttafuoco	male
Joey_Harrington	male
Joey_Mantia	male
Joe_Calzaghe	male
Joe_Carnahan	male
Joe_Cocker	male
Joe_Cravens	male
Joe_Crede	male
Joe_Darrell	male
Joe_DeLamielleure	male
Joe_Dicaro	male
Joe_Dumars	male
Joe_Finley	male
Joe_Friedberg	male
Joe_Garner	male
Joe_Gatti	male
Joe_Glover	male
Joe_Leonard	male
Joe_Lieberman	male
Joe_Mantegna	male
Joe_Mantello	male
Joe_Mendes	male
Joe_Metz	male
Joe_Nichols	male
Joe_Pantoliano	male
Joe_Paterno	male
Joe_Plumeri	male
Joe_Strummer	male
Joe_Torre	male
Joe_Vandever	male
Johannes_Rau	male
Johan_Bruyneel	male
Johnnie_Lynn	male
Johnny_Benson	male
Johnny_Carson	male
Johnny_Depp	male
Johnny_Hallyday	male
Johnny_Htu	male
Johnny_Tapia	male
Johnny_Unitas	male
Johnson_Panjaitan	male
John_Abizaid	male
John_Allen_Muhammad	male
John_Anderson	male
John_Ashcroft	male
John_Baldacci	male
John_Banko	male
John_Barnett	male
John_Belushi	male
John_Blaney	male
John_Bolton	male
John_Bond	male
John_Brady	male
John_Burkett	male
John_Burnett	male
John_Connolly	male
John_Coomber	male
John_Cornyn	male
John_Cruz	male
John_Cusack	male
John_Dallager	male
John_Daly_Jr	male
John_Danforth	male
John_Darby	male
John_Duprey	male
John_Eastman	male
John_Eder	male
John_Edwards	male
John_Elway	male
John_Engler	male
John_Fenn	male
John_Ferguson	male
John_Fox	male
John_Franco	male
John_F_Kennedy_Jr	male
John_Garamendi	male
John_Geoghan	male
John_Goold	male
John_Gordnick	male
John_Gruden	male
John_Hartson	male
John_Henry	male
John_Herrington	male
John_Howard	male
John_Jones	male
John_Jumper	male
John_Kerr	male
John_Kerry	male
John_Lawrence	male
John_Leguizamo	male
John_Lennon	male
John_Lisowski	male
John_Lithgow	male
John_Lynch	male
John_Mabry	male
John_Madden	male
John_Malkovich	male
John_Manley	male
John_Marburger	male
John_Mayer	male
John_McCain	male
John_McCallum	male
John_McCormack	male
John_McEnroe	male
John_McKay	male
John_Moe	male
John_Moxley	male
John_Nash	male
John_Negroponte	male
John_Nimmo	male
John_Norquist	male
John_Paul_DeJoria	male
John_Paul_II	male
John_Perrota	male
John_Petty	male
John_Philip_Elkann	male
John_Prescott	male
John_Reid	male
John_Reilly	male
John_Richardson	male
John_Rigas	male
John_Robbins	male
John_Rosa	male
John_Rowe	male
John_Rowland	male
John_Ruiz	male
John_Rusnak	male
John_Salazar	male
John_Scarlett	male
John_Sidgmore	male
John_Snow	male
John_Spencer	male
John_Stallworth	male
John_Starks	male
John_Stockton	male
John_Sununu	male
John_Sweeney	male
John_Swofford	male
John_Taylor	male
John_Thune	male
John_Timoney	male
John_Travolta	male
John_Tyson	male
John_Velazquez	male
John_Walsh	male
John_Warner	male
John_Wayne	male
John_White	male
John_Williams	male
John_Wolf	male
John_Wright	male
Jolanta_Kwasniewski	female
Jonathan_Arden	male
Jonathan_Byrd	male
Jonathan_Edwards	male
Jonathan_Fine	male
Jonathan_Horton	male
Jonathan_Karsh	male
Jonathan_Mostow	male
Jonathan_Schroeder	male
Jonathan_Tiomkin	male
Jonathan_Woodgate	male
Jong_Thae_Hwa	male
Jong_Wook_Lee	male
Jon_Constance	male
Jon_Corzine	male
Jon_Gruden	male
Jon_Kitna	male
Jon_Stewart	male
Jon_Voight	male
Jorge_Alberto_Galindo	male
Jorge_Arce	male
Jorge_Batlle	male
Jorge_Castaneda	male
Jorge_Enrique_Jimenez	male
Jorge_Marquez-Ruarte	male
Jorge_Moreno	male
Jorge_Quiroga	male
Jorge_Rodolfo_Canicoba_Corral	male
Jorge_Valdano	male
Jorma_Huhtala	male
Joschka_Fischer	male
Joseph_Biden	male
Joseph_Blatter	male
Joseph_Deiss	male
Joseph_Estrada	male
Joseph_Fiennes	male
Joseph_Galante	male
Joseph_Ganim	male
Joseph_Hoy	male
Joseph_Kabila	male
Joseph_LePore	male
Joseph_Lopez	male
Joseph_Nacchio	male
Joseph_Ralston	male
Joseph_Safra	male
Joseph_Salgado	male
Jose_Acasuso	male
Jose_Alencar	male
Jose_Bove	male
Jose_Canseco	male
Jose_Canseco_Sr	male
Jose_Carlo_Fernandez	male
Jose_Carreras	male
Jose_Cevallos	male
Jose_Dirceu	male
Jose_Genoino	male
Jose_Jose	male
Jose_Lina	male
Jose_Lopez_Beltran	male
Jose_Luis_Chilavert	male
Jose_Luis_Rodriguez_Zapatero	male
Jose_Luis_Santiago_Vasconcelos	male
Jose_Manuel_Durao_Barroso	male
Jose_Maria_Aznar	male
Jose_Miguel_Aleman	male
Jose_Mourinho	male
Jose_Rosado	male
Jose_Santos	male
Jose_Sarney	male
Jose_Serra	male
Jose_Theodore	male
Jose_Vicente_Rangel	male
Jose_Viegas_Filho	male
Jose_Woldenberg	male
Joshua_Davey	male
Joshua_Gracin	male
Joshua_Harapko	male
Joshua_Perper	male
Josh_Childress	male
Josh_Evans	male
Josh_Kronfeld	male
Joxel_Garcia	male
Joy_Bryant	female
Joy_Lee_Sadler	male
Jo_Dee_Messina	female
Jo_Joong-hyon	male
JP_Suarez	male
JT_Snow	male
Juanes	male
Juan_Antonio_Samaranch	male
Juan_Carlos	male
Juan_Carlos_Ferrero	male
Juan_Carlos_Morales	male
Juan_Carlos_Ortega	male
Juan_Fernandez	male
Juan_Francisco_Palencia	male
Juan_Ignacio_Chela	male
Juan_Jose_Lucas	male
Juan_Manuel_Marquez	male
Juan_Pablo_Montoya	male
Juan_Roman_Carrasco	male
Juan_Roman_Riquelme	male
Juan_Sanchez	male
Juan_Valencia_Osorio	male
Judd_Davies	male
Jude_Law	male
Judith_Nathan	female
Judi_Dench	female
Judi_Patton	female
Judy_Dean	female
Judy_Genshaft	female
Judy_Locy	female
Judy_Spreckels	female
Judy_Vassar	female
Juergen_Braehmer	male
Juergen_Chrobog	male
Juergen_Peters	male
Juergen_Schrempp	male
Juergen_Trittin	male
Jules_Asner	female
Julianna_Margulies	female
Julianne_Moore	female
Julian_Battle	male
Julian_Fantino	male
Julia_Glass	female
Julia_Ormond	female
Julia_Tymoshenko	male
Julien_Boutter	male
Julien_Varlet	male
Juliette_Binoche	female
Juliette_Lewis	female
Julie_Andrews	female
Julie_Gerberding	female
Julie_Goodenough	female
Julie_Infante	female
Julie_Taymor	female
Julio_Cesar_Chavez	male
Julio_Cesar_Franco	male
Julio_De_Brun	male
Julio_Iglesias_Jr	male
Julio_Rossi	male
Julio_Toro	male
Julius_Barnes	male
Julius_Erving	male
Juljia_Vysotskij	female
Jung_Bong	male
Junichiro_Koizumi	male
Junichi_Inamoto	male
Junko_Tabei	male
Justine_Henin	female
Justine_Pasek	female
Justin_Gatlin	male
Justin_Guarini	male
Justin_Leonard	male
Justin_Marshall	male
Justin_Timberlake	male
Justin_Wilson	male
Kai-Uwe_Ricke	male
Kaio_Almeida	male
Kaisser_Bazan	male
Kajsa_Bergqvist	female
Kalid_Kaid	male
Kalpana_Chawla	male
Kamal_Kharrazi	male
Kamel_Morjane	male
Kang_Gum-sil	male
Kaoru_Hasuike	male
Kara_Lynn_Joyce	female
Kareena_Kapoor	female
Karen_Allen	female
Karen_Clarkson	female
Karen_Lynn_Gorney	female
Karen_Mok	female
Karen_Pereiras	female
Karen_Sharpe_Kramer	female
Karin_Pilsaeter	female
Karin_Stoiber	female
Karin_Viard	female
Karl-Heinz_Rummenigge	male
Karol_Kucera	male
Kaspar_Villiger	male
Katalin_Kollat	female
Katerina_Smrzova	female
Kate_Burton	female
Kate_Capshaw	female
Kate_Hudson	female
Kate_Lee	female
Kate_Moss	female
Kate_Richardson	female
Kate_Starbird	female
Kate_Winslet	female
Katharine_Hepburn	female
Katherine_Harris	female
Kathie_Louise_Saunders	female
Kathleen_Abernathy	female
Kathleen_Glynn	female
Kathleen_Kennedy_Townsend	female
Kathryn_Bigelow	female
Kathryn_Grayson	female
Kathryn_Morris	female
Kathryn_Tucker	female
Kathy_Baker	female
Kathy_Bates	female
Kathy_Gannon	female
Kathy_Winters	female
Katie_Boone	female
Katie_Couric	female
Katie_Harman	female
Katie_Holmes	female
Katie_Smith	female
Katie_Wagner	female
Katja_Riemann	female
Katrin_Cartlidge	female
Katrin_Susi	female
Kaye_Young	female
Kay_Bailey_Hutchison	female
Kay_Behrensmeyer	female
Keanu_Reeves	male
Keiko_Sofia_Fujimori	female
Keira_Knightley	female
Keith_Bishop_Jr	male
Keith_Bogans	male
Keith_Brown	male
Keith_Fotta	male
Keith_Foulke	male
Keith_Lockhart	male
Keith_Lowen	male
Keith_Olbermann	male
Keith_Osik	male
Keith_Rodriguez	male
Keith_Snyder	male
Keith_Tyson	male
Keith_Urban	male
Keith_Van_Horn	male
Keizo_Yamada	male
Kellie_Coffey	male
Kellie_Greene	female
Kelli_White	male
Kelly_Clarkson	female
Kelly_Leigh	female
Kelly_Osbourne	female
Kelly_Ripa	female
Kelly_Santos	female
Kelsey_Grammer	male
Kelvin_Sampson	male
Kemal_Dervis	male
Kenenisa_Bekele	male
Kenneth_Bowersox	male
Kenneth_Branagh	male
Kenneth_Brill	male
Kenneth_Carlsen	male
Kenneth_Cooper	male
Kenneth_Dam	male
Kenneth_Evans	male
Kenneth_Reichert	male
Kenny_Brack	male
Kenny_Chesney	male
Kent_McCord	male
Kent_Robinson	male
Kent_Rominger	male
Ken_Balk	male
Ken_Dorsey	male
Ken_Kutaragi	male
Ken_Loach	male
Ken_Macha	male
Ken_Watanabe	male
Ken_Wharfe	male
Kevin_Borseth	male
Kevin_Costner	male
Kevin_Crane	male
Kevin_Garnett	male
Kevin_Gil	male
Kevin_Harvick	male
Kevin_Hearn	male
Kevin_James	male
Kevin_Keegan	male
Kevin_Marshall	male
Kevin_Millwood	male
Kevin_Nealon	male
Kevin_Satterfield	male
Kevin_Sorbo	male
Kevin_Spacey	male
Kevin_Stallings	male
Kevin_Tarrant	male
Khader_Rashid_Rahim	male
Khaled_Sawalhi	male
Khalid_Khannouchi	male
Khalid_Qazi	male
Khatol_Mohammad_Zai	male
Khin_Nyunt	male
Khum_Bahadur_Khadka	male
Kieran_Culkin	male
Kieran_Prendergast	male
Kifah_Ajouri	male
Kiki_Vandeweghe	male
Kimberly_Bruckner	female
Kimberly_Stewart	female
Kimi_Raikkonen	male
Kimora_Lee	female
Kim_Cattrall	female
Kim_Chinn	female
Kim_Clijsters	female
Kim_Dae-jung	male
Kim_Dong-hwa	male
Kim_Dong-tae	male
Kim_Gandy	female
Kim_Hong-gul	male
Kim_Hong-up	male
Kim_Jin-sun	male
Kim_Jong-Il	male
Kim_Ryong-sung	male
Kim_Su_Nam	male
Kim_Weeks	male
Kim_Yong-il	male
Kim_Yun-kyu	male
King_Abdullah_II	male
King_Bhumibol_Adulyadej	male
King_Gyanendra	male
Kirby_Puckett	male
Kirk_Doerger	male
Kirk_Douglas	male
Kirk_Ferentz	male
Kirk_Franklin	male
Kirk_Johnson	male
Kirsten_Clark	female
Kirsten_Dunst	female
Kirsten_Gilham	female
Kitin_Munoz	male
Kit_Bond	male
Kjell_Magne_Bondevik	male
Klaus_Schwab	male
Klaus_Zwickel	male
Kobe_Bryant	male
Kofi_Annan	male
Koichiro_Matsuura	male
Koichi_Haraguchi	male
Koichi_Tanaka	male
Koji_Uehara	male
Kong_Quan	male
Kostya_Tszyu	male
Kosuke_Kitajima	male
Krishna_Bhadur_Mahara	male
Kristanna_Loken	female
Kristen_Breitweiser	female
Kristen_Rivera	female
Kristin_Chenoweth	female
Kristin_Davis	female
Kristin_Scott	female
Kristin_Scott_Thomas	female
Kristy_Curry	female
Kultida_Woods	female
Kurt_Budke	male
Kurt_Busch	male
Kurt_Hellstrom	male
Kurt_Russell	male
Kurt_Schottenheimer	male
Kurt_Suzuki	male
Kurt_Tanabe	male
Kurt_Thomas	male
Kurt_Warner	male
Kwame_Kilpatrick	male
Kweisi_Mfume	male
Kwon_Yang-sook	female
Kwon_Young-gil	male
Kyle_McLaren	male
Kyle_Shewfelt	male
Kyoko_Nakayama	female
Kyra_Sedgwick	female
Lachlan_Murdoch	male
Laila_Ali	female
Lana_Clarkson	female
Lance_Armstrong	male
Lance_Bass	male
Landon_Donovan	male
Lane_Bryant	female
Lane_Odom	male
Lara_Logan	female
Larenz_Tate	male
Larry_Anderson	male
Larry_Beinfest	male
Larry_Bowa	male
Larry_Brown	male
Larry_Campbell	male
Larry_Coker	male
Larry_Donald	male
Larry_Ellison	male
Larry_Eustachy	male
Larry_Flynt	male
Larry_Greene	male
Larry_Hagman	male
Larry_Hahn	male
Larry_Harris	male
Larry_Johnson	male
Larry_Lindsey	male
Larry_Lucchino	male
Larry_Nichols	male
Larry_Pleau	male
Larry_Ralston	male
Larry_Tanenbaum	male
Larry_Templeton	male
Larry_Thompson	male
Larry_Wilmore	male
Lars_Burgsmuller	male
Lars_Von_Trier	male
Laszlo_Kovacs	male
Latrell_Sprewell	male
Laura_Bozzo	female
Laura_Bush	female
Laura_Elena_Harring	female
Laura_Flessel	female
Laura_Gobai	female
Laura_Hernandez	female
Laura_Linney	female
Laura_Marlow	female
Laura_Morante	female
Laura_Pausini	female
Laura_Romero	female
Laura_Schlessinger	female
Laura_Ziskin	female
Laurel_Clark	female
Laurence_Fishburne	male
Laurence_Tribe	male
Laurent_Gbagbo	male
Laurent_Jalabert	male
Laurent_Woulzy	male
Lauren_Hutton	female
Lauren_Killian	female
Laurie_Chan	male
Laurie_Hobbs	female
Laurie_Laychak	female
Laurie_Pirtle	female
Lawrence_Di_Rita	male
Lawrence_Foley	male
Lawrence_MacAulay	male
Lawrence_Roberts	male
Lawrence_Vito	male
Lazaro_Castro	female
Leah_Remini	female
Leander_Paes	male
Leandrinho_Barbosa	male
Leandro_Andrade	male
Leandro_Garcia	male
LeAnn_Rimes	female
Lea_Fastow	female
LeBron_James	male
Lech_Walesa	male
Lee_Ann_Knight	female
Lee_Ann_Terlaji	female
Lee_Ann_Womack	female
Lee_Baca	male
Lee_Byung-woong	male
Lee_Chang-dong	male
Lee_Hoi-chang	male
Lee_Hong-ki	male
Lee_Hyung-taik	male
Lee_Jun	male
Lee_Nam-shin	male
Lee_Soo-hyuck	male
Lee_Tae-sik	male
Lee_Yeo-jin	male
Lee_Yuan-tseh	male
Leigh_Winchell	male
Leisel_Jones	female
Leland_Chapman	male
Lela_Rochon	female
Lemuel_Montulo	male
Lena_Katina	female
Lena_Olin	female
Lene_Espersen	female
Leni_Bjorklund	male
Lennart_Johansson	male
Lennox_Lewis	male
Lenny_Kravitz	male
Lenny_Wilkens	male
Len_Jenoff	male
Leonardo_Del_Vecchio	male
Leonardo_DiCaprio	male
Leonardo_Fernandez	male
Leonard_Glick	male
Leonard_Hamilton	male
Leonard_Schrank	male
Leonid_Kuchma	male
Leon_Barmore	male
Leon_Lai	male
Leon_LaPorte	male
Leon_Silver	male
Leo_Mullin	male
Leo_Ramirez	male
LeRoy_Millette_Jr	male
Lesia_Burlak	female
Lesley_Coppin	female
Lesley_Flood	female
Lesley_McCulloch	female
Leslie_Ann_Woodward	female
Leslie_Caldwell	female
Leslie_Moonves	male
Leslie_Wiser_Jr	male
Lester_Holt	male
Leszek_Miller	male
Leticia_Dolera	female
Leticia_Van_de_Putte	female
Leuris_Pupo	male
Lewis_Booth	male
Lew_Rywin	male
Liam_Neeson	male
Liane_Janda	female
Lidija_Djukanovic	female
Liliana_Cavani	female
Lili_Marinho	female
Lili_Taylor	female
Lily_Safra	female
Lily_Tomlin	female
Lima_Azimi	female
Lim_Dong-won	male
Lina_Krasnoroutskaya	female
Lincoln_Chafee	female
Linda_Amicangioli	female
Linda_Baboolal	female
Linda_Dano	female
Linda_Franklin	female
Linda_Ham	female
Linda_Lingle	female
Linda_Mason	female
Linda_Sanchez	female
Lindsay_Benko	male
Lindsay_Davenport	female
Lindsay_Lohan	female
Lindsey_Graham	male
Lindy_Ruff	male
Linn_Thornton	male
Lino_Oviedo	male
Linus_Roache	male
Lin_Yi-fu	male
Lin_Yung_Hsi	male
Lionel_Chalmers	male
Lionel_Hampton	male
Lionel_Richie	male
Lisa_Girman	female
Lisa_Gottsegen	female
Lisa_Leslie	female
Lisa_Ling	female
Lisa_Marie_Presley	female
Lisa_Murkowski	female
Lisa_Raymond	female
Lisa_Stansfield	female
Lisa_Stone	female
Liu_Mingkang	male
Liu_Xiaoqing	female
Liu_Ye	male
Liv_Tyler	female
Liza_Minnelli	female
Li_Changchun	male
Li_Ka-shing	male
Li_Peng	male
Li_Ruihuan	male
Li_Zhaoxing	male
LK_Advani	male
Lleyton_Hewitt	male
Lloyd_Mudiwa	male
Lloyd_Novick	male
Lloyd_Richards	male
Lloyd_Ward	male
Lois_Smart	female
Lokendra_Bahadur_Chand	male
Lonnie_Donegan	male
Lon_Kruger	male
Lope_Mendoza	male
Lord_Hutton	male
Loretta_Lynn_Harper	female
Lori_Berenson	female
Lorne_Michaels	male
Lorraine_Bracco	female
Lorraine_Fenton	female
Louisa_Baileche	female
Louis_Van_Gaal	male
Lou_Lang	male
Lou_Piniella	male
Lou_Reed	male
Lou_Ye	male
Lubomir_Zaoralek	male
Lucas_Wysocki	male
Luca_Cordero_di_Montezemolo	male
Luciano_Bovicelli	male
Luciano_Pavarotti	male
Lucia_Kenny_Anthony	male
Lucie_Lapovsky	female
Lucio_Angulo	male
Lucio_Cecchinello	male
Lucio_Gutierrez	male
Lucio_Stanca	male
Lucrecia_Orozco	male
Lucy_Liu	female
Luc_Montagnier	male
Ludivine_Sagnier	female
Ludwig_Ovalle	male
Luis_Berrondo	male
Luis_Ernesto_Derbez_Bautista	male
Luis_Figo	male
Luis_Fonsi	male
Luis_Gonzalez	male
Luis_Gonzalez_Macchi	male
Luis_Guzman	male
Luis_Horna	male
Luis_Pujols	male
Luis_Rosario_Huertas	male
Luis_Sanchez	male
Luiz_Felipe_Scolari	male
Luiz_Inacio_Lula_da_Silva	male
Luke_Ridnour	male
Luke_Smith	male
Luke_Walton	male
Luo_Linquan	male
Luther_Htu	male
Lutz_Freitag	male
Lydia_Shum	male
Lyle_Lovett	male
Lyle_Vanclief	male
Lynne_Cheney	female
Lynne_Slepian	female
Lynne_Thigpen	female
Lynn_Abraham	male
Lynn_Redgrave	female
Lyudmila_Putin	female
Mack_Brown	male
Madeleine_Albright	female
Madeleine_Webber	female
Madge_Overhouse	female
Madonna	female
Mae_Jemison	female
Magdalena_Maleeva	female
Magda_Kertasz	female
Maggie_Cheung	female
Maggie_Smith	female
Magui_Serna	female
Mahathir_Mohamad	male
Maha_Habib	female
Mahdi_Al_Bassam	male
Mahendra_Chaudhry	male
Mahima_Chaudhari	female
Mahmoud_Abbas	male
Mahmoud_Al_Zhar	male
Mahmoud_Diyab_al-Ahmed	male
Makhdoom_Amin_Fahim	male
Makiko_Tanaka	female
Makiya_Ali_Hassan	female
Malak_Habbak	female
Malcolm_Glazer	male
Malcolm_Jamal_Warner	male
Malcolm_Wild	male
Malik_Mahmud	male
Mamdouh_Habib	male
Manfred_Reyes_Villa	male
Manfred_Stolpe	male
Manijeh_Hekmat	female
Manuela_Montebrun	male
Manuel_Gehring	male
Manuel_Jesus	male
Manuel_Llorente	male
Manuel_Pellegrini	male
Manuel_Poggiali	male
Manuel_Rosendo	male
Marat_Safin	male
Mara_Georges	female
Marc-Andre_Fleury	male
Marcella_Anderson	female
Marcelo_Bielsa	male
Marcelo_Ebrard	male
Marcelo_Rios	male
Marcelo_Salas	male
Marcio_de_Souza	male
Marcos_Cafu	male
Marcos_Daniel_Jimenez	male
Marcos_Milinkovic	male
Marco_Antonio_Barrera	male
Marco_Archer_Cardoso_Moreira	male
Marco_Irizarry	male
Marco_Pantani	male
Marcus_Allen	male
Marcus_Garrettson	male
Marcus_Gronholm	male
Marc_Anthony	male
Marc_Bulger	male
Marc_Gold	male
Marc_Grossman	male
Marc_Leger	male
Marc_Racicot	male
Marc_Shaiman	male
Margaret_Caruso	female
Margaret_Hasley	female
Margaret_Hoelzer	female
Margaret_Okayo	female
Margaret_Thatcher	female
Margerry_Bakley	female
Margie_Puente	female
Mariah_Carey	female
Mariam_Ali_Hassan	female
Mariana_Gonzalez	female
Mariana_Ohata	female
Mariana_Pollack	female
Mariangel_Ruiz_Torrealba	female
Marianne_Stanley	female
Mariano_Zabaleta	male
Marian_Dolan	male
Maria_Bello	female
Maria_Burks	male
Maria_Callas	female
Maria_Conchita_Alonso	female
Maria_Garcia	female
Maria_Guida	female
Maria_Luisa_Mendonca	male
Maria_Sanchez_Lorenzo	female
Maria_Shkolnikova	male
Maria_Shriver	female
Maria_Simon	female
Maria_Soledad_Alvear_Valenzuela	female
Maria_Wetterstrand	female
Maribel_Dominguez	female
Marie-Josee_Croze	female
Marie-Reine_Le_Gougne	female
Marieta_Chrousala	female
Marie_Haghal	female
Marilyn_Monroe	female
Marina_Anissina	female
Marina_Canetti	female
Marina_Hands	female
Marina_Kuptsova	female
Marina_Silva	female
Marion_Barry	male
Marion_Fahnestock	female
Mario_Alfaro-Lopez	female
Mario_Austin	male
Mario_Cipollini	male
Mario_Dominguez	male
Mario_Dumont	male
Mario_Gallegos	male
Mario_Jardel	male
Mario_Kreutzberger	male
Mario_Lemieux	male
Mario_Lobo_Zagallo	male
Mario_Puzo	male
Mario_Vasquez_Rana	male
Marisa_Tomei	female
Marisol_Breton	male
Marisol_Martinez_Sambran	male
Marissa_Jaret_Winokur	female
Maritza_Macias_Furano	male
Markus_Beyer	male
Markus_Naslund	male
Mark_Andrew	male
Mark_Bellhorn	male
Mark_Broxmeyer	male
Mark_Butcher	male
Mark_Cuban	male
Mark_Dacey	male
Mark_Everson	male
Mark_Foley	male
Mark_Gangloff	male
Mark_Geragos	male
Mark_Gottfried	male
Mark_Hamister	male
Mark_Hanson	male
Mark_Heller	male
Mark_Hogan	male
Mark_Hurlbert	male
Mark_Kelly	male
Mark_Komara	male
Mark_Lazarus	male
Mark_Leno	male
Mark_Mariscal	male
Mark_Martin	male
Mark_McClellan	male
Mark_Mishkin	male
Mark_Mulder	male
Mark_Philippoussis	male
Mark_Podlesny	male
Mark_Polansky	male
Mark_Redman	male
Mark_Richt	male
Mark_Rosenbaum	male
Mark_Sacco	male
Mark_Salter	male
Mark_Schweiker	male
Mark_Shapiro	male
Mark_Sisk	male
Mark_Stuart	male
Mark_Swartz	male
Mark_Wahlberg	male
Mark_Warner	male
Marlene_Weingartner	male
Marlon_Devonish	male
Marquier_Montano_Contreras	male
Marquis_Estill	male
Marricia_Tate	female
Marsah_Ambrosius	female
Marsha_Sharp	female
Marsha_Thomason	female
Marta_Dominguz	female
Martha_Beatriz_Roque	female
Martha_Bowen	female
Martha_Burk	female
Martha_Lucia_Ramirez	female
Martha_Martinez_Flores	female
Martha_Sahagun_de_Fox	female
Martha_Smith	female
Martha_Stewart	female
Martie_Maguire	female
Martina_Hingis	female
Martina_McBride	female
Martin_Bandier	male
Martin_Boryczewski	male
Martin_Brodeur	male
Martin_Brooke	male
Martin_Burnham	male
Martin_Cauchon	male
Martin_Frost	male
Martin_Gecht	male
Martin_Hoellwarth	male
Martin_Howard	male
Martin_Keown	male
Martin_Kristof	male
Martin_Landau	male
Martin_Lawrence	male
Martin_Luther_King_III	male
Martin_McCauley	male
Martin_McGuinness	male
Martin_ONeill	male
Martin_Rodriguez	male
Martin_Scorsese	male
Martin_Sheen	male
Martin_Short	male
Martin_Torrijos	male
Martin_Verkerk	male
Marty_Mornhinweg	male
Marvan_Atapattu	male
Marwan_Barghouthi	male
Marwan_Muasher	male
Mary-Kate_Olsen	female
Maryn_McKenna	female
Mary_Anne_Souza	female
Mary_Blige	female
Mary_Bono	female
Mary_Carey	female
Mary_Catherine_Correll	female
Mary_Descenza	female
Mary_Elizabeth_Mastrantonio	female
Mary_Frances_Seiter	female
Mary_Hill	female
Mary_Jo_Myers	female
Mary_Katherine_Smart	female
Mary_Landrieu	female
Mary_Lou_Markakis	female
Mary_Lou_Retton	female
Mary_Maddux	female
Mary_Matalin	female
Mary_McCarty	female
Mary_Robinson	female
Mary_Steenburgen	female
Mary_Sue_Coleman	female
Mary_Tyler_Moore	female
Mary_Zorn	female
Masahiko_Nagasawa	male
Masamori_Tokuyama	male
Masao_Azuma	male
Masaru_Hayami	male
Masatoshi_Koshiba	male
Masja_Juel	female
Massoud_Barzani	male
Masum_Turker	male
Mathias_Reichhold	male
Mathilda_Karel_Spak	male
Matthew_Broderick	male
Matthew_During	male
Matthew_McConaughey	male
Matthew_Ouimet	male
Matthew_Perry	male
Matthew_Vaughan	male
Matthias_Sammer	male
Matt_Anderson	male
Matt_Braker	male
Matt_Damon	male
Matt_Dillon	male
Matt_Doherty	male
Matt_Herden	male
Matt_LeBlanc	male
Matt_Morris	male
Matt_Roney	male
Matt_Siebrandt	male
Matt_Walters	male
Matt_Welsh	male
Maura_Tierney	female
Maureen_Fanning	female
Maureen_Kanka	female
Maurice_Cheeks	male
Maurice_Papon	male
Maurice_Strong	male
Mauricio_Macri	male
Mauricio_Pochetino	male
Mauro_Viza	male
Maxim_Afinogenov	male
Max_Baucus	male
Max_Biaggi	male
Max_Mayfield	male
Max_Mosley	male
Max_von_Sydow	female
Mayumi_Moriyama	female
McGuire_Gibson	male
MC_Hammer	male
Megan_Mullally	female
Megawati_Sukarnoputri	female
Meghann_Shaughnessy	female
Meg_Mallon	female
Meg_Wakeman	female
Mehdi_Baala	male
Mehmet_Ali_Sahin	male
Mehmet_Okur	male
Meirion_Evans	male
Mekhi_Phifer	male
Melana_Scantlin	female
Melanie_Griffith	female
Melchor_Cob_Castro	male
Meles_Zenawi	male
Melina_Kanakaredes	female
Melinda_Czink	male
Melissa_Etheridge	female
Melissa_Gilbert	female
Melissa_Joan_Hart	female
Melissa_Manchester	male
Melissa_Mulloy	female
Melissa_Stark	female
Melvin_Talbert	male
Mel_Brooks	male
Mel_Gibson	male
Mel_Karmazin	male
Mercedes_Amor	female
Meryl_Streep	female
Mesut_Yilmaz	male
Mian_Khursheed_Mehmood_Kasuri	male
Mia_Mottley	female
Micah_Knorr	male
Michael_Adams	male
Michael_Andretti	male
Michael_Arif	male
Michael_Ballack	male
Michael_Bloomberg	male
Michael_Bolton	male
Michael_Bouchard	male
Michael_Boyce	male
Michael_Brandon	male
Michael_Broad	male
Michael_Caine	male
Michael_Capellas	male
Michael_Chang	male
Michael_Chertoff	male
Michael_Chiklis	male
Michael_Clarke_Duncan	male
Michael_Dell	male
Michael_DeMinico	male
Michael_Denzel	male
Michael_Deutsch	female
Michael_Diekmann	male
Michael_Doleac	male
Michael_Donovan	male
Michael_Douglas	male
Michael_Fitzgerald	male
Michael_Frayn	male
Michael_Friedman	male
Michael_Goldrich	male
Michael_Guiler	male
Michael_Hagee	male
Michael_Haneke	male
Michael_Hoffa	male
Michael_Jackson	male
Michael_Jasny	male
Michael_Jordan	male
Michael_J_Fox	male
Michael_J_Sheehan	male
Michael_Kahn	male
Michael_Keaton	male
Michael_Killeen	male
Michael_Kirby	male
Michael_Kors	male
Michael_Kostelnik	male
Michael_Leavitt	male
Michael_Lechner	male
Michael_Linscott	male
Michael_Lopez-Alegria	male
Michael_McNeely	male
Michael_Michele	female
Michael_Milton	male
Michael_Moore	male
Michael_Munoz	male
Michael_Olowokandi	male
Michael_Patrick_King	male
Michael_Peat	male
Michael_Pfleger	male
Michael_Phelps	male
Michael_Piuze	male
Michael_Powell	male
Michael_Richards	male
Michael_Rolinee	male
Michael_Schumacher	male
Michael_Shane_Jolly	male
Michael_Sheehan	male
Michael_Shelby	male
Michael_Smith_Foster	male
Michael_Stark	male
Michael_Sullivan	male
Michael_Taylor	male
Michael_Wayne	male
Michael_Weiss	male
Michael_Winterbottom	male
Michalis_Chrisohoides	male
Micheal_Jourdain_Jr	male
Michelangelo_Antonioni	male
Michele_Placido	male
Michelle_Bachelet	female
Michelle_Branch	female
Michelle_Chiklis	female
Michelle_Collins	female
Michelle_Hofland	female
Michelle_Kwan	female
Michelle_Lecky	female
Michelle_Pfeiffer	female
Michelle_Rodriguez	female
Michelle_Yeoh	female
Michel_Charles_Chretien	male
Michel_Duclos	male
Michel_Kratochvil	male
Michel_Minard	male
Michel_Temer	male
Michel_Therrien	male
Mickey_Gilley	male
Mickey_Loomis	male
Mickey_Rooney	male
Mickey_Sherman	male
Micky_Arison	male
Micky_Ward	male
Mick_Jagger	male
Mick_McCarthy	male
Miguel_Aldana_Ibarra	male
Miguel_Angel_Rodriguez	male
Miguel_Contreras	male
Miguel_Cotto	male
Miguel_Estrada	male
Miguel_Hakim	male
Miguel_Jimenez	male
Miguel_Juarez_Perez	male
Miguel_Rosseto	male
Mika_Hakkinen	male
Mike_Alden	male
Mike_Babcock	male
Mike_Bair	male
Mike_Brey	male
Mike_Bryan	male
Mike_Carona	male
Mike_Cunning	male
Mike_Davis	male
Mike_Duke	male
Mike_Easley	male
Mike_Eskew	male
Mike_Farrar	male
Mike_Fisher	male
Mike_Flanagan	male
Mike_Gable	male
Mike_Helton	male
Mike_Holmgren	male
Mike_Johanns	male
Mike_Krzyzewski	male
Mike_Leach	male
Mike_Maroth	male
Mike_Martz	male
Mike_Matheny	male
Mike_Matthews	male
Mike_Miller	male
Mike_Montgomery	male
Mike_Myers	male
Mike_OConnell	male
Mike_Price	male
Mike_Richter	male
Mike_Samp	male
Mike_Scioscia	male
Mike_Sherman	male
Mike_Slive	male
Mike_Smith	male
Mike_Stefanik	male
Mike_Sweeney	male
Mike_Szymanczyk	male
Mike_Thibault	male
Mike_Tice	male
Mike_Tyson	male
Mike_Webster	male
Mike_Weir	male
Mikhail_Gorbachev	male
Mikhail_Kalashnikov	male
Mikhail_Kasyanov	male
Mikhail_Khodorkovsky	male
Mikhail_Shvydkoi	male
Mikhail_Wehbe	male
Mikhail_Youzhny	male
Mikulas_Dzurinda	male
Milan_Kucan	male
Milan_Milutinovic	male
Miles_Stewart	male
Mile_Mrksic	male
Millicent_Martin	male
Milo_Djukanovic	male
Milo_Maestrecampo	male
Milton_Berle	male
Milton_Wynants	male
Milt_Heflin	male
Milt_Palacio	male
Minnie_Driver	female
Minnie_Mendoza	male
Miranda_Gaddis	female
Miranda_Otto	female
Mira_Sorvino	female
Mireille_Jospin-Dandieu	male
Mirela_Manjani	female
Mireya_Elisa_Moscoso_Rodriguez	male
Mireya_Moscoso	male
Miroljub	male
Missy_Crider	female
Misty_Dawn_Clymer	female
Mitar_Rasevic	male
Mitchell_Crooks	male
Mitchell_Daniels	male
Mitchell_Garabedian	male
Mitchell_McLaughlin	male
Mitchell_Potter	male
Mitchell_Swartz	male
Mitch_Kupchak	male
Mitoji_Yabunaka	male
Mitsou_Gelinas	female
Mitt_Romney	male
Mitzi_Gaynor	male
Miyako_Miyazaki	female
Mladen_Naletilic	male
Moby	male
Mohamed_Benaissa	male
Mohamed_ElBaradei	male
Mohamed_Hammam	male
Mohamed_Seineldin	male
Mohammad_Aktar	male
Mohammad_Al-Sharief	male
Mohammad_Fares	male
Mohammad_Hasanein	male
Mohammad_Khatami	male
Mohammad_Mustapha_Miro	male
Mohammaed_Ahmad_Al_Jarallah	male
Mohammed_Abulhasan	male
Mohammed_Abu_Sharia	male
Mohammed_Al-Douri	male
Mohammed_Al_Hindi	male
Mohammed_Ashraf_Hafiz	male
Mohammed_Baqir_al-Hakim	male
Mohammed_Dahlan	male
Mohammed_Mehdi_Saleh	male
Mohammed_Salmane	male
Molly_Sims	female
Momcilo_Perisic	male
Momir_Nikolic	male
Mona_Ayoub	male
Mona_Locke	male
Mona_Rishmawi	female
Monica_Bellucci	female
Monica_Gabrielle	male
Monica_Lewinsky	female
Monica_Seles	female
Monica_Serra	female
Monica_Vergara	female
Monique_Ferreira	male
Monique_Gagnon-Tremblay	male
Monique_Garbrecht-Enfeldt	male
Monte_Kiffin	male
Moon-So-ri	female
Morgan_Fairchild	female
Morgan_Freeman	male
Morgan_Hentzen	male
Morris_Dees	male
Morris_Watts	male
Moshe_Katsav	male
Mother_Teresa	male
Mo_Elleithee	male
Mstislav_Rostropovich	male
Ms_Dynamite	female
Muammar_Gaddafi	male
Muffet_McGraw	female
Mufti_Mohammad_Syed	male
Muhammad_Ali	male
Muhammad_Ibrahim_Bilal	male
Muhammad_Saeed_al-Sahhaf	male
Mukesh_Ambani	male
Mukhtar_Alytnbayev	male
Munir_Akram	male
Muwafak_al-Ani	male
Myung_Yang	female
Nabil_Shaath	male
Nadia_Forte	female
Nadia_Petrova	male
Nadine_Vinzens	female
Najib_al-Salhi	male
Naji_Sabri	male
Namuddu_Florence	female
Nancy_Demme	female
Nancy_Greenlaw	male
Nancy_Humbert	female
Nancy_Kerrigan	female
Nancy_Pelosi	female
Nancy_Powell	female
Nancy_Reagan	female
Nancy_Sinatra	female
Nancy_Smith	female
Nanni_Moretti	male
Nan_Wang	female
Naomi_Bronstein	male
Naomi_Campbell	female
Naomi_Hayashi	female
Naomi_Watts	female
Naoto_Kan	male
Narayan_Singh_Pun	male
Narendra_Modi	male
Nasser_al-Kidwa	male
Nastassia_Kinski	female
Nastia_Liukin	female
Natalia_Dmitrieva	female
Natalia_Motuziuk	female
Natalia_Verbeke	female
Natalia_Vodonova	female
Natalie_Cole	female
Natalie_Coughlin	female
Natalie_Imbruglia	female
Natalie_Juniardi	female
Natalie_Maines	female
Natalie_Stewart	female
Natalie_Williams	female
Natalya_Sazanovich	female
Natanaela_Barnova	female
Natasa_Micic	female
Natasha_Henstridge	female
Natasha_Lyonne	female
Natasha_McElhone	female
Nate_Blackwell	male
Nate_Huffman	male
Nate_Hybl	male
Nathalia_Gillot	female
Nathalie_Baye	female
Nathalie_Dechy	female
Nathalie_Gagnon	female
Nathan_Doudney	male
Nathan_Lane	male
Nathan_Powell	male
Nathan_Smith	male
Nathirah_Hussein	male
Nawabzada_Nasrullah_Khan	male
Na_Na_Keum	female
Nebojsa_Pavkovic	male
Neil_Goldman	male
Neil_Moritz	male
Nelson_Acosta	male
Nelson_Mandela	male
Nelson_Shanks	male
Neri_Marcore	male
Nestor_Gonzalez	male
Nestor_Kirchner	male
Nestor_Santillan	male
Newton_Carlton_Slawson	male
Newt_Gingrich	male
Niall_Connolly	male
Nia_Vardalos	female
Nicanor_Duarte_Frutos	male
Nicholas_Byron	male
Nicholas_Tse	male
Nicholoas_DiMarzio	male
Nicklas_Lidstrom	male
Nick_Cassavetes	male
Nick_Markakis	male
Nick_Nolte	male
Nick_Price	male
Nick_Rahall	male
Nick_Reilly	male
Nick_Rimando	male
Nick_Turner	male
Nicolas_Cage	male
Nicolas_Escude	male
Nicolas_Eyzaguirre	male
Nicolas_Kiefer	male
Nicolas_Lapentti	male
Nicolas_Latorre	male
Nicolas_Macrozonaris	male
Nicolas_Massu	male
Nicolas_Sarkozy	male
Nicola_Bono	male
Nicola_Wells	female
Nicole	female
Nicoletta_Braschi	female
Nicole_Hiltz	female
Nicole_Kidman	female
Nicole_Parker	female
Nida_Blanca	female
Nigel_Redden	male
Nikki_Cascone	female
Nikki_McKibbin	female
Nikki_Reed	female
Nikki_Teasley	male
Nikolay_Davydenko	male
Nila_Ferran	female
Nina_Jacobson	female
Nina_Pecari	female
Nino_DAngelo	male
Nizar_Trabelsi	male
Noah_Wyle	male
Nobuyuki_Idei	male
Noelle_Bush	female
Noel_Forgeard	male
Noel_Niell	female
Noer_Moeis	male
Noer_Muis	male
Nona_Gaye	female
Nong_Duc_Manh	male
Noor_Mohammed	male
Norah_Jones	female
Nora_Bendijo	female
Nora_Ephron	female
Norbert_van_Heyst	male
Norio_Ohga	male
Normand_Legault	male
Norman_Jewison	male
Norman_Mailer	male
Norman_Mineta	male
Norm_Coleman	male
Norm_Macdonald	male
Norodom_Chakrapong	male
Norodom_Sihanouk	male
Nova_Esther_Guthrie	female
Nuon_Chea	male
Nursultan_Nazarbayev	male
Nur_Jaafar	male
Octavio_Lara	male
Odai_Hussein	male
Odilia_Collazo	female
OJ_Simpson	male
Oleg_Romantsev	male
Oleksandr_Moroz	male
Olene_Walker	male
Olesya_Bonabarenko	female
Olivera_Labus	male
Oliver_Neuville	male
Oliver_Phelps	male
Oliver_Stone	male
Olivia_Newton-John	female
Olivier_Boulay	male
Olivier_Rochus	male
Olympia_Dukakis	female
Omar_el-Heib	male
Omar_Khan_Sharif	male
Omar_Sharif	male
Omar_Vizquel	male
Ontario_Lett	male
Oprah_Winfrey	female
Oracene_Williams	female
Orlando_Bloom	male
Ornella_Muti	female
Orrin_Hatch	male
Osama_Al_Baz	male
Osama_bin_Laden	male
Oscar_Bolanos	male
Oscar_De_La_Hoya	male
Oscar_de_la_Renta	male
Oscar_DLeon	male
Oscar_Elias_Biscet	male
Osmond_Smith	male
Osrat_Iosef	female
Oswaldo_Paya	male
Oswald_Gruebel	male
Otto_Reich	male
Otto_Schily	male
Owen_Nolan	male
Owen_Wilson	male
Oxana_Fedorova	female
Ozzie_Smith	male
Ozzy_Osbourne	female
Pablo_Khulental	male
Pablo_Latras	male
Paddy_Long	male
Paddy_Torsney	female
Padraig_Harrington	male
Paek_Nam_Sun	male
Paige_Fitzgerald	female
Pak_Gil_Yon	male
Pamela_Anderson	female
Pamela_Melroy	male
Paola_Espinoza	male
Paradorn_Srichaphan	male
Paris_Hilton	female
Park_Jie-won	male
Park_Jung_Sung	male
Park_Na-kyong	female
Parris_Glendening	male
Parthiv_Patel	male
Pascal_Affi_Nguessan	male
Pascal_Lamy	male
Pascal_Quignard	male
Pascal_Rheaume	male
Patrice_Chereau	male
Patricia_Clarkson	female
Patricia_Garone	female
Patricia_Hearst	female
Patricia_Heaton	female
Patricia_Johnson	female
Patricia_Medina	female
Patricia_Phillips	female
Patricia_Russo	female
Patricia_Wartusch	female
Patrick_Bourrat	male
Patrick_Clawsen	male
Patrick_Coleman	male
Patrick_Dennehy	male
Patrick_Eaves	male
Patrick_Ewing	male
Patrick_Kron	male
Patrick_Leahy	male
Patrick_McEnroe	male
Patrick_Rafter	male
Patrick_Roy	male
Patrick_Stewart	male
Patrik_Kristiansson	male
Patsy_Hardy	female
Patsy_Kensit	female
Patsy_Mink	female
Patti_Balgojevich	female
Patti_Labelle	female
Patti_Lank	female
Patti_Smith	female
Patty_Duke	female
Patty_Schnyder	female
Patty_Sheehan	female
Pat_Burns	male
Pat_Cox	male
Pat_DAmuro	male
Pat_Riley	male
Pat_Rochester	male
Pat_Summerall	male
Pat_Summitt	female
Pat_Wharton	female
Paul-Henri_Mathieu	male
Paula_Abdul	female
Paula_Dobriansky	female
Paula_Locke	female
Paula_Prentiss	female
Paula_Radcliffe	female
Paula_Zahn	female
Pauley_Perrette	female
Paulie_Ayala	male
Paulina_Rodriguez_Davila	female
Pauline_Landers	female
Pauline_Phillips	female
Paulo_Cesar_Pinheiro	male
Paul_Bettany	male
Paul_Brandt	male
Paul_Bremer	male
Paul_Burrell	male
Paul_Byrd	male
Paul_Celluci	male
Paul_Cerjan	male
Paul_Clark	male
Paul_Coppin	male
Paul_Crake	male
Paul_Desmarais	male
Paul_Ebert	male
Paul_Farley	male
Paul_Gannon	male
Paul_Gascoigne	male
Paul_Greengrass	male
Paul_Henderson	male
Paul_Hogan	male
Paul_Johnson	male
Paul_Kagame	male
Paul_Kariya	male
Paul_Kelleher	male
Paul_Krueger	male
Paul_LeClerc	male
Paul_Li_Calsi	male
Paul_Lockhart	male
Paul_Lo_Duca	male
Paul_Luvera	male
Paul_Martin	male
Paul_McCartney	male
Paul_McNulty	male
Paul_Michael_Daniels	male
Paul_Murphy	male
Paul_Newman	male
Paul_ONeill	male
Paul_Otellini	male
Paul_Patton	male
Paul_Pierce	male
Paul_Reiser	male
Paul_Sarbanes	male
Paul_Schrader	male
Paul_Shanley	male
Paul_Tagliabue	male
Paul_Tracy	male
Paul_Vathis	male
Paul_Walker	male
Paul_Wals	male
Paul_Wellstone	male
Paul_William_Hurley	male
Paul_Wilson	male
Paul_Wolfowitz	male
Paul_Wollnough	male
Pa_Kou_Hang	male
Pedro_Almodovar	male
Pedro_Alvarez	male
Pedro_Duque	male
Pedro_Mahecha	male
Pedro_Malan	male
Pedro_Martinez	male
Pedro_Pauleta	male
Pedro_Solbes	male
Pedro_Velasquez	male
Peggy_McGuinness	female
Pele	male
Penelope_Ann_Miller	female
Penelope_Cruz	female
Penelope_Taylor	female
Penny_Dupuie	female
Penny_Lancaster	female
Percy_Gibson	male
Peri_Gilpin	female
Pernilla_Bjorn	female
Perri_Shaw	female
Perry_Compton	male
Perry_Farrell	male
Perry_Gibbs	male
Pervez_Musharraf	male
Peter_Ahearn	male
Peter_Albertsen	male
Peter_Arnett	male
Peter_Bacanovic	male
Peter_Camejo	male
Peter_Care	male
Peter_Caruana	male
Peter_Chan	female
Peter_Costello	male
Peter_Fisher	male
Peter_Fitzgerald	male
Peter_Fonda	male
Peter_Gabriel	male
Peter_Gilmour	male
Peter_Goldmark	male
Peter_Greenaway	male
Peter_Greenspun	male
Peter_Harrison	male
Peter_Hartz	male
Peter_Harvey	male
Peter_Hillary	male
Peter_Hollingworth	male
Peter_Holmberg	male
Peter_Hunt	male
Peter_Lundgren	male
Peter_Mackay	male
Peter_Mansbridge	male
Peter_Max	male
Peter_Medgyessy	male
Peter_Mugyeni	male
Peter_Mullan	male
Peter_OToole	male
Peter_Rasch	female
Peter_Rasmussen	male
Peter_Schultz	male
Peter_Sejna	male
Peter_Shaw	male
Peter_Struck	male
Peter_Ueberroth	male
Pete_Aldridge	male
Pete_Beaudrault	male
Pete_Carroll	male
Pete_Gillen	male
Pete_Rose	male
Pete_Sampras	male
Petria_Thomas	male
Petro_Symonenko	male
Pham_Sy_Chien	male
Pham_Thi_Mai_Phuong	female
Phan_Van_Khai	male
Pharrell_Williams	male
Philippe_Gagnon	male
Philippe_Noiret	male
Philip_Cummings	male
Philip_Murtaugh	male
Philip_Zalewski	male
Phillipe_Comtois	male
Phillips_Idowu	male
Phillip_Fulmer	male
Phillip_Seymor_Hoffmann	male
Phil_Bennett	male
Phil_Bredesen	male
Phil_Cline	male
Phil_Cullen	male
Phil_Donahue	male
Phil_Gramm	male
Phil_Jackson	male
Phil_Johnson	male
Phil_McGraw	male
Phil_Mickelson	male
Phil_Morris	male
Phil_Vassar	male
Phoenix_Chang	female
Picabo_Street	male
Pierce_Brosnan	male
Pierre_Boulanger	male
Pierre_Gagnon	male
Pierre_Lacroix	male
Pierre_Pettigrew	male
Pierre_Png	male
Pierre_Van_Hooijdonk	male
Piers_Sellers	male
Pier_Ferdinando_Casini	male
Pieter_Bouw	male
Pilar_Montenegro	female
Pinar_del_Rio	male
Piotr_Anderszewski	male
Pio_Laghi	male
Placido_Domingo	male
Platon_Lebedev	male
Poala_Suarez	male
Polona_Bas	female
Porter_Goss	male
Portia_de_Rossi	female
Prakash_Hinduja	male
Prem_Kumar_Nair	male
Princess_Aiko	female
Princess_Anne	female
Princess_Caroline	female
Princess_Diana	female
Princess_Elisabeth	female
Princess_Hisako	female
Princess_Masako	female
Princess_Maxima	female
Princess_Stephanie	female
Princess_Victoria	female
Prince_Charles	male
Prince_Claus	male
Prince_Edward	male
Prince_Felipe	male
Prince_Harry	male
Prince_Naruhito	male
Prince_Philippe	male
Prince_Rainier_III	male
Prince_Willem-Alexander	male
Prince_William	male
Pringe_Ernst_August	male
Priscilla_Owen	female
Priscilla_Presley	female
Priyanka_Chopra	female
Prospero_Pichay	male
Pupi_Avati	male
Pyar_Jung_Thapa	male
Qais_al-Kazali	male
Qazi_Afzal	male
Qazi_Hussain_Ahmed	male
Qian_Qichen	male
Queen_Beatrix	female
Queen_Elizabeth_II	female
Queen_Latifah	female
Queen_Noor	female
Queen_Rania	female
Queen_Silvia	female
Queen_Sofia	female
Quincy_Jones	male
Quin_Snyder	male
Qusai_Hussein	male
Raaf_Schefter	male
Raag_Singhal	male
Rachel_Corrie	female
Rachel_Griffiths	female
Rachel_Hunter	female
Rachel_Kempson	female
Rachel_Leigh_Cook	female
Rachel_Roy	female
Rachel_Wadsworth	female
Rachel_Wheatley	female
Radovan_Karadzic	male
Rafael_Bielsa	male
Rafael_Ramirez	male
Rafael_Vinoly	male
Rafeeuddin_Ahmed	male
Rafidah_Aziz	female
Rafiq_Hariri	male
Raf_Vallone	male
Raghad_Saddam_Hussein	female
Rahul_Dravid	male
Rainer_Geulen	male
Rainer_Gut	male
Rainer_Schuettler	male
Raja_Ibrahim	male
Raja_Qureshi	male
Raja_Ramani	male
Raja_Zafar-ul-Haq	male
Ralf_Schumacher	male
Ralph_Fiennes	male
Ralph_Firman	male
Ralph_Friedgen	male
Ralph_Goodale	male
Ralph_Klein	male
Ralph_Lauren	male
Ralph_Nader	male
Ralph_Sampson	male
Ramiro_Goben_Reducindo	male
Ramona_Rispton	female
Ramon_Cardenas	male
Ramon_Delgado	male
Ramon_Ponce_de_Leon	male
Ramon_Santana	male
Randall_Terry	male
Randall_Tobias	male
Randy_Brown	male
Randy_Dryer	male
Randy_Ferbey	male
Randy_Jackson	male
Randy_Johnson	male
Randy_Travis	male
Rand_Beers	male
Rand_Miller	male
Ranil_Wickremasinghe	male
Rani_Mukherjee	male
Raoul_Ruiz	male
Raquel_Welch	female
Rashid_Qureshi	male
Ratna_Sari_Dewi_Sukarno	female
Raul_Castaneda	male
Raul_Chacon	male
Raul_Cubas	male
Raul_Gonzalez	male
Raul_Ibanez	male
Raul_Mondesi	male
Raul_Rivero	male
Ravan_AG_Farhadi	male
Raymond_Arthurs	male
Raymond_Odierno	male
Ray_Allen	male
Ray_Bradbury	male
Ray_Evernham	male
Ray_Halbritter	male
Ray_Lewis	male
Ray_Liotta	male
Ray_Lucas	male
Ray_Morrough	male
Ray_Nagin	male
Ray_Price	male
Ray_Romano	male
Ray_Sherman	male
Ray_Wasden	male
Ray_Young	male
Razali_Ismail	male
Raza_Rabbani	male
Rebecca_Romijn-Stamos	female
Rebekah_Chantay_Revels	female
Recep_Tayyip_Erdogan	male
Red_Auerbach	male
Reese_Witherspoon	female
Reggie_Lewis	male
Reggie_Miller	male
Reggie_Sanders	male
Reginald_Hudlin	male
Regina_Ip	female
Reina_Hayes	female
Reinhard_Buetikofer	male
Renato_Soru	male
Rena_Sofer	female
Renee_Zellweger	female
Rene_Antonio_Leon_Rodriguez	male
Rene_Portland	female
Ren_Qingjin	male
Retief_Goosen	male
Reyyan_Uzuner	female
Rey_Sanchez	male
Rhett_Warrener	male
Rhina_Villatoro	female
Ricardo_Lagos	male
Ricardo_Lopez_Murphy	male
Ricardo_Maduro	male
Ricardo_Mayorga	male
Ricardo_Monasterio	male
Ricardo_Sanchez	male
Riccardo_Muti	male
Richard_Armitage	male
Richard_Barry	male
Richard_Branson	male
Richard_Butler	male
Richard_Carl	male
Richard_Chamberlain	male
Richard_Cohen	male
Richard_Crenna	male
Richard_Daley	male
Richard_Dreyfuss	male
Richard_Fine	male
Richard_Gephardt	male
Richard_Gere	male
Richard_Greenberg	male
Richard_Haass	male
Richard_Hamilton	male
Richard_Harris	male
Richard_Hellfant	male
Richard_Jefferson	male
Richard_Jewell	male
Richard_Krajicek	male
Richard_Langille	male
Richard_Lennon	male
Richard_Levin	male
Richard_Lugar	male
Richard_Myers	male
Richard_Naughton	male
Richard_Norton-Taylor	male
Richard_Palmer	male
Richard_Parsons	male
Richard_Paul_Evans	male
Richard_Penniman	female
Richard_Pennington	male
Richard_Perle	male
Richard_Regenhard	male
Richard_Reid	male
Richard_Rodriguez	male
Richard_Sambrook	male
Richard_Shelby	male
Richard_Sterner	male
Richard_Tubb	male
Richard_Virenque	male
Richard_Ward	male
Richie_Adubato	male
Rich_Brooks	male
Rich_Gannon	male
Ricky_Barnes	male
Ricky_Cottrill	male
Ricky_Martin	male
Ricky_Ponting	male
Ricky_Quick	male
Ricky_Ray	male
Rick_Barnes	male
Rick_Bland	male
Rick_Bragg	male
Rick_Carlisle	male
Rick_Caruso	male
Rick_Dinse	male
Rick_Husband	male
Rick_Lu	male
Rick_Perry	male
Rick_Pitino	male
Rick_Reed	male
Rick_Rickert	male
Rick_Romley	male
Rick_Santorum	male
Rick_Stansbury	male
Rick_Wagoner	male
Ridley_Scott	male
Riek_Blanjaar	male
Rien_Long	male
Rina_Lazo	female
Ringo_Starr	male
Rio_Ferdinand	male
Rita_Grande	female
Rita_Moreno	female
Rita_Wilson	female
Robbie_Coltrane	male
Robbie_Fowler	male
Robbie_Mc_Ewen	male
Robbie_Naish	male
Robbie_Williams	male
Robby_Ginepri	male
Roberta_Combs	female
Roberto_Arguelles	male
Roberto_Benigni	male
Roberto_Canessa	male
Roberto_Carlos	male
Roberto_Cavalli	male
Roberto_Cercelletta	male
Roberto_Guaterroma	male
Roberto_Laratro	male
Roberto_Lavagna	male
Roberto_Marinho	male
Roberto_Robaina	male
Roberto_Tovar	male
Robert_Altman	male
Robert_Beck	male
Robert_Blackwill	male
Robert_Blake	male
Robert_Bonner	male
Robert_Bullock	male
Robert_DeFraites	male
Robert_De_Niro	male
Robert_Douglas	male
Robert_Downey_Jr	male
Robert_Durst	male
Robert_Duvall	male
Robert_Ehrlich	male
Robert_Evans	male
Robert_Fico	male
Robert_Flodquist	male
Robert_F_Kennedy_Jr	male
Robert_Gallo	male
Robert_Gordon_Card	male
Robert_Hanssen	male
Robert_Horan	male
Robert_Hyatt	male
Robert_Kipkoech_Cheruiyot	male
Robert_Kocharian	male
Robert_Korzeniowski	male
Robert_Lange	male
Robert_Lee_Yates_Jr	male
Robert_Marshall	male
Robert_McKee	male
Robert_Morvillo	male
Robert_Mueller	male
Robert_Mugabe	male
Robert_Nardelli	male
Robert_Nillson	male
Robert_Pollack	male
Robert_Redford	male
Robert_Schuller	male
Robert_Stack	male
Robert_Torricelli	male
Robert_Towne	male
Robert_Tyrrell	male
Robert_Vowler	male
Robert_Wagner	male
Robert_Weitzel	male
Robert_Wiener	male
Robert_Witt	male
Robert_Woody_Johnson	male
Robert_Zoellick	male
Robinson_Stevenin	male
Robin_Cook	male
Robin_Johansen	male
Robin_McGraw	female
Robin_McLaurin_Williams	male
Robin_Tunney	female
Robin_Wagner	female
Robin_Williams	male
Robin_Wright_Penn	female
Rob_Lowe	male
Rob_Marshall	male
Rob_Moore	male
Rob_Morrow	male
Rob_Niedermayer	male
Rob_Ramsay	male
Rob_Schneider	male
Rocco_Buttiglione	male
Rodney_Dangerfield	male
Rodney_Rempt	male
Rodolfo_Abalos	female
Rodrigo_Borja	male
Rodrigo_de_la_Cerna	male
Rodrigo_Rato	male
Rod_Blagojevich	male
Rod_Bryden	male
Rod_Jong-il	male
Rod_Paige	male
Rod_Stewart	male
Rod_Thorn	male
Roel_Campos	male
Rogelio_Montemayor	male
Rogelio_Ramos	male
Rogerio_Romero	male
Roger_Clemens	male
Roger_Cook	male
Roger_Corbett	male
Roger_Daltrey	male
Roger_Etchegaray	male
Roger_Federer	male
Roger_Grimes	male
Roger_King	male
Roger_Lyons	male
Roger_Machado	male
Roger_Mahony	male
Roger_Moore	male
Roger_Penske	male
Roger_Staubach	male
Roger_Suarez	male
Roger_Toussaint	male
Roger_Winter	male
Rohinton_Mistry	male
Rohman_al-Ghozi	male
Roh_Moo-hyun	male
Rolandas_Paksas	male
Roland_Koch	male
Rolf_Eckrodt	male
Rolf_Zimmermann	male
Rollie_Massimino	male
Romain_Duris	male
Romano_Prodi	male
Roman_Abramovich	male
Roman_Coppola	male
Roman_Polanski	male
Roman_Tam	male
Romario_Farias	male
Romeo_Gigli	male
Ronaldo_Luis_Nazario_de_Lima	male
Ronald_Brower	male
Ronald_Harwood	male
Ronald_Ito	male
Ronald_Kadish	male
Ronald_Kessler	male
Ronald_Perelman	male
Ronald_Post	male
Ronald_Reagan	male
Ronald_White	male
Ronald_Young_Jr	male
Ronde_Barber	male
Ronnie_Jagday	male
Ronnie_Musgrove	male
Ron_Dittemore	male
Ron_Gonzales	male
Ron_Howard	male
Ron_Kirk	male
Ron_Lantz	male
Ron_Zook	male
Rosalie_Perkov	female
Rosalyn_Carter	female
Rosario_Dawson	female
Rosa_Haywa_de_Condori	female
Roseanne_Barr	female
Rosemarie_Stack	female
Rose_Linkins	female
Rose_Marie	female
Rosie_Perez	female
Rosny_Desroches	male
Ross_Verba	male
Rowan_Williams	male
Roy_Blunt	male
Roy_Chaderton	male
Roy_Halladay	male
Roy_Jones_Jr	male
Roy_Moore	male
Roy_Rogers	male
Roy_Romanow	male
Roy_Williams	male
Ruano_Pascual	male
Rubens_Barrichello	male
Ruben_Sierra	male
Ruben_Studdard	male
Ruben_Wolkowyski	male
Rudi_Voeller	male
Rudolf_Schuster	male
Rudolph_Giuliani	male
Rudolph_Holton	male
Rudy_Tomjanovich	male
Rulon_Gardner	male
Rupert_Grint	female
Rupert_Murdoch	male
Russell_Coutts	male
Russell_Crowe	male
Russell_Simmons	male
Russ_Ortiz	male
Rustu_Recber	male
Ruth_Bader_Ginsburg	male
Ruth_Christofferson	male
Ruth_Dreifuss	male
Ruth_Harlow	male
Ruth_Pearce	male
Ruth_Stubbs	male
Ryan_Drese	male
Ryan_Goodman	male
Ryan_Leaf	male
Ryan_Newman	male
Ryan_Nyquist	male
Saadi_Gadhafi	male
Sabah_Al-Ahmad_Al-Jaber_Al-Sabah	male
Saburo_Kawabuchi	male
Sachiko_Yamada	male
Sachin_Tendulkar	male
Sadam_Hassan	male
Sada_Jacobson	male
Saddam_Hussein	male
Sadie_Frost	female
Saeb_Erekat	male
Saeed_Anwar	male
Saeed_Mortazavi	male
Sahim_Alwan	male
Saied_Hadi_al_Mudarissi	male
Sally_Clark	female
Sally_Field	female
Sally_Kirkland	female
Sally_Ride	female
Salman_Khan	male
Salman_Rushdie	male
Salma_Hayek	female
Samantha_Daniels	female
Samantha_Ledster	male
Saman_Shali	male
Samira_Makhmalbaf	female
Sami_Al-Arian	male
Sammy_Knight	male
Sammy_Sosa	male
Samuel_Waksal	male
Sam_Bith	male
Sam_Brownback	male
Sam_Gerald	male
Sam_Mendes	male
Sam_Rockwell	male
Sam_Torrance	male
Sananda_Maitreya	male
Sandra_Banning	female
Sandra_Bullock	female
Sandra_Ceccarelli	female
Sandra_Day_OConner	female
Sandra_Milo	female
Sandra_Shamas	female
Sandy_Smith	male
Sandy_Wise	female
Sanjay_Chawla	male
Sanjay_Gupta	male
Sanja_Papic	female
Santiago_Botero	male
San_Lan	female
Saoud_Al_Faisal	male
Saparmurat_Niyazov	male
Sarah_Canale	female
Sarah_Hughes	female
Sarah_Jessica_Parker	female
Sarah_Michelle_Gellar	female
Sarah_Price	female
Sarah_Weddington	female
Sarah_Wynter	female
Sara_Elisabeth_Ahmad	female
Sara_Silverman	female
Sargis_Sargsian	male
Sasha_Alexander	female
Sasha_Cohen	female
Satnarine_Sharma	male
Scott_Blum	male
Scott_Dalton	male
Scott_Dickson	male
Scott_Fawell	male
Scott_Gorelick	male
Scott_Hamilton	male
Scott_Hoch	male
Scott_Hubbard	male
Scott_McClellan	male
Scott_McNealy	male
Scott_OGrady	male
Scott_Peterson	male
Scott_Ritter	male
Scott_Rolen	male
Scott_Rudin	male
Scott_Sullivan	male
Scott_Verplank	male
Scott_Wallach	male
Scott_Weiland	male
Scott_Wittman	male
Scott_Wolf	male
Scott_Yates	male
Sean_Astin	male
Sean_Combs	male
Sean_Hayes	male
Sean_OKeefe	male
Sean_Patrick_OMalley	male
Sean_Patrick_Thomas	male
Sean_Penn	male
Sean_Townsend	male
Sebastian_Cuattrin	male
Sebastian_Porto	male
Sebastian_Saja	male
Sebastien_Grosjean	male
Sedigh_Barmak	male
Selma_Phoenix	female
Sepp_Blatter	male
Serena_Karlan	female
Serena_Williams	male
Sereyvuth_Kem	male
Sergei_Alexandrovitch_Ordzhonikidze	male
Sergei_Ivanov	male
Sergei_Yastrzhembsky	male
Sergei_Yushenkov	male
Sergey_Lavrov	male
Serge_Klarsfeld	male
Serge_Melac	male
Serge_Tchuruk	male
Sergio_Castellitto	male
Sergio_Garcia	male
Sergio_Vieira_De_Mello	male
Seth_Gorney	male
Severino_Antinori	male
Seydou_Diarra	male
Seymour_Cassell	male
Se_Hyuk_Joo	male
Shae-Lynn_Bourne	female
Shafal_Mosed	male
Shamai_Leibowitz	male
Shane_Hmiel	male
Shane_Loux	male
Shane_Mosley	male
Shane_Phillips	male
Shane_Reynolds	male
Shane_Warne	male
Shania_Twain	female
Shanna_Zolman	female
Shannon_OBrien	female
Shannyn_Sossamon	female
Sharess_Harrell	female
Sharon_Davis	female
Sharon_Frey	female
Sharon_Osbourne	female
Sharon_Robinson	female
Sharon_Stone	female
Shaukat_Aziz	male
Shaul_Mofaz	male
Shaun_Pollock	male
Shaun_Rusling	male
Shavon_Earp	female
Shawn_Bradley	male
Shawn_Kemp	male
Shawn_Marion	male
Sheikh_Ahmed_Yassin	male
Sheila_Copps	female
Sheila_Fraser	female
Sheila_Taormina	female
Sheila_Wellstone	female
Sheldon_Silver	male
Sherri_Coale	female
Sherry_Fisher	female
Sherry_Irving	female
Sheryl_Crow	female
Shia_LaBeouf	male
Shigeo_Nagashima	male
Shigeru_Ishiba	male
Shimon_Peres	male
Shingo_Katayama	male
Shingo_Suetsugu	male
Shinya_Taniguchi	male
Shinzo_Abe	male
Shireen_Amir_Begum	male
Shirley_Jones	female
Shi_Guangsheng	male
Shobha_De	female
Shoshana_Johnson	female
Shoshannah_Stern	female
Sidney_Kimmel	male
Sidney_Poitier	male
Sid_Caesar	male
Sigourney_Weaver	female
Sila_Calderon	female
Silvan_Shalom	male
Silvia_Farina_Elia	male
Silvie_Cabero	female
Silvio_Berlusconi	male
Silvio_Fernandez	male
Simona_Hradil	female
Simon_Chalk	male
Simon_Cowell	male
Simon_Larose	female
Simon_Yam	male
Sim_Yong	male
Sinead_OConnor	male
Sivan_Klein	female
SJ_Twu	male
Skip_Prosser	male
Slobodan_Milosevic	male
Soenarno	male
Sofia_Milos	female
Sofyan_Dawood	male
Sohail_Abbas	male
Sok_An	male
Solomon_Passy	male
Sonia_Gandhi	female
Sonia_Lopez	female
Sonja_Kesselschlager	female
Sonya_Walger	female
Soon_Yi	female
Sophia_Loren	female
Sophie	male
Sourav_Ganguly	male
Spencer_Abraham	male
Spike_Helmick	male
Spike_Jonze	male
Spike_Lee	male
Stacey_Dales-Schuman	male
Stacey_Jones	male
Stacey_Yamaguchi	female
Stacy_Dragila	female
Stacy_Nelson	female
Stanislas_Wawrinka	male
Stanley_Ho	male
Stanley_McChrystal	male
Stanley_Nelson	male
Stanley_Tong	male
Stan_Heath	male
Stan_Kasten	male
Stan_Kroenke	male
Stefaan_Declerk	male
Stefanie_De_Roux	female
Stefano_Accorsi	male
Stefano_Basalini	male
Stefano_Gabbana	male
Stefan_Holm	male
Stefan_Koubek	male
Stefan_Tafrov	male
Steffeny_Holtz	female
Steffi_Graf	female
Stellan_Skarsgard	male
Stella_Keitel	female
Stella_McCartney	female
Stella_Tennant	male
Steny_Hoyer	male
Stepan_Demirchian	male
Stephane_Delajoux	male
Stephane_Rochon	male
Stephane_Rousseau	male
Stephanie_Cohen_Aloro	male
Stephanie_Moore	female
Stephanie_Zimbalist	male
Stephan_Eberharter	male
Stephen_Ambrose	male
Stephen_Arigbabu	male
Stephen_Cooper	male
Stephen_Covey	male
Stephen_Crampton	male
Stephen_Daldry	male
Stephen_Ebberharter	male
Stephen_Frears	male
Stephen_Friedman	male
Stephen_Funk	male
Stephen_Glassroth	male
Stephen_Joseph	male
Stephen_Keener	male
Stephen_Oake	male
Stephen_Push	male
Stephen_Silas	male
Stephen_Swindal	male
Stephen_Thompson	male
Stephen_Webster	male
Sterling_Hitchcock	male
Steve-O	male
Steven_Briggs	male
Steven_Craig	male
Steven_Curtis_Chapman	male
Steven_Feldman	male
Steven_Hatfill	male
Steven_Kinlock	male
Steven_Seagal	female
Steven_Spielberg	male
Steven_Tyler	male
Steven_Van_Zandt	male
Steve_Alford	male
Steve_Allan	male
Steve_Allee	male
Steve_Austin	male
Steve_Avery	male
Steve_Backley	male
Steve_Ballmer	male
Steve_Blake	male
Steve_Blankenship	male
Steve_Case	male
Steve_Coogan	male
Steve_Coterill	male
Steve_Cox	male
Steve_Cutler	male
Steve_Fehr	male
Steve_Karsay	male
Steve_Kerr	male
Steve_Largent	male
Steve_Lavin	male
Steve_Lenard	male
Steve_Mariucci	male
Steve_McManaman	male
Steve_Nash	male
Steve_Nesbitt	male
Steve_Pagliuca	male
Steve_Park	male
Steve_Patterson	male
Steve_Peace	male
Steve_Phillips	male
Steve_Redgrave	male
Steve_Rush	male
Steve_Shiver	male
Steve_Spurrier	male
Steve_Stirling	male
Steve_Valentine	male
Steve_Wariner	male
Steve_Waugh	male
Steve_Zahn	male
Stipe_Mesic	male
Stockard_Channing	female
Strom_Thurmond	male
Stuart_Knoll	male
Stuart_Townsend	male
Stuart_Whitman	male
Sue_Grafton	female
Sue_Guevara	female
Sue_Johnston	female
Sue_Slavec	female
Sue_Wicks	female
Suh_Chung-won	male
Suh_Young-hoon	male
Suk_Chung_Hong	female
Sultan_Qaboos	male
Sung_Hong_Choi	male
Sun_Myung_Moon	male
Supachai_Panitchpakdi	male
Surakait_Sathirathai	male
Sureyya_Ayhan	female
Surya_Bahadur_Thapa	male
Susan_Collins	female
Susan_Sarandon	female
Susan_Walvius	female
Susan_Whelan	male
Sushma_Swaraj	male
Susie_Castillo	female
Susilo_Bambang_Yudhoyono	male
Suzanne_Fox	female
Suzanne_Gaudet	female
Suzanne_Haik_Terrell	female
Suzanne_Mubarak	female
Suzanne_Somers	female
Suzanne_Torrance	female
Suzie_McConnell_Serio	female
Svend_Aage_Jensby	male
Svend_Robinson	male
Sven_Goran_Eriksson	male
Sven_Ottke	male
Svetislav_Pesic	female
Svetlana_Belousova	female
Svetlana_Koroleva	female
Svetoslav_Todorov	male
Sybille_Schmid	female
Syed_Abdul_Rahman_Geelani	male
Syed_Ibrahim	male
Sylvester_Stallone	male
Sylvia_Plachy	female
Sylvie_Guillem	female
Szu_Yu_Chen	female
S_Jayakumar	male
Tabare_Vazquez	male
Tab_Baldwin	male
Tab_Turner	male
Taha_Yassin_Ramadan	male
Taia_Balk	male
Takahiro_Mori	male
Takaloo	male
Takashi_Sorimachi	male
Takashi_Yamamoto	male
Takenori_Kanzaki	male
Takeo_Fukui	male
Takeo_Hiranuma	male
Takeshi_Kitano	male
Takuma_Sato	male
Taku_Yamasaki	male
Talal_Keenaan	male
Talisa_Bratt	female
Talisa_Soto	female
Tali_Imani	female
Tamara_Brooks	female
Tamara_Mowry	female
Tamara_Stokes	female
Tamika_Catchings	female
Tammy_Helm	female
Tammy_Lynn_Michaels	female
Tangra_Riggle	female
Tang_Jiaxuan	male
Tanya_Holyk	male
Tanya_Lindenmuth	female
Taoufik_Mathlouthi	male
Tara_Dawn_Christensen	female
Tara_Kirk	female
Tara_Reid	female
Tara_VanDerveer	female
Tariq_Aziz	male
Tassos_Papadopoulos	male
Tatiana_Gratcheva	female
Tatiana_Kennedy_Schlossberg	female
Tatiana_Panova	female
Tatiana_Paus	female
Tatiana_Shchegoleva	female
Tatjana_Gsell	female
Tatsuya_Fuji	male
Tatyana_Tomashova	female
Taufik_Hidayat	male
Taufik_Kiemas	male
Tavis_Smiley	male
Taylor_Twellman	male
Taylyn_Solomon	male
Tayshaun_Prince	male
Tayyeb_Abdel_Rahim	male
TA_McLendon	male
Teddy_Kollek	male
Ted_Christopher	male
Ted_Costa	male
Ted_Maher	male
Ted_Nolan	male
Ted_Turner	male
Ted_Washington	male
Ted_Williams	male
Terence_Newman	male
Teresa_Graves	female
Teresa_Heinz_Kerry	female
Teresa_Williams	female
Teresa_Worbis	female
Teri_Files	female
Teri_Garr	female
Teri_ORourke	female
Terje_Roed-Larsen	male
Terrell_Suggs	male
Terrence_Kiel	male
Terrence_Trammell	male
Terri_Clark	female
Terry_Bradshaw	male
Terry_Gilliam	male
Terry_Hoeppner	male
Terry_Lynn_Barton	female
Terry_McAuliffe	male
Terry_Semel	male
Terry_Stotts	male
Teruaki_Masumoto	male
Terunobu_Maeda	male
Tessa_Jowell	male
Tex_Ritter	male
Thabo_Mbeki	male
Thad_Matta	male
Thaksin_Shinawatra	male
Thalia	female
Thanongsak_Tuvinan	male
Theodore_Tweed_Roosevelt	male
Theo_Angelopoulos	male
Theo_Epstein	male
Theresa_Gattung	female
Theresa_May	female
Thierry_Falise	male
Thierry_Mariani	male
Thomas_Birmingham	male
Thomas_Bjorn	male
Thomas_Cloyd	male
Thomas_Daily	male
Thomas_Day	male
Thomas_Enqvist	male
Thomas_Fargo	male
Thomas_Ferguson	male
Thomas_Franklin	male
Thomas_Gottschalk	male
Thomas_Haeggstroem	male
Thomas_Kelly	male
Thomas_Klestil	male
Thomas_Malchow	male
Thomas_Manger	male
Thomas_Mesereau_Jr	male
Thomas_OBrien	male
Thomas_Rupprath	male
Thomas_Scavone	male
Thomas_Stewart	male
Thomas_Ulrich	male
Thomas_Van_Essen	male
Thomas_Watjen	male
Thomas_Weston	male
Thomas_Wilkens	male
Thomas_Wyman	male
Thor_Pedersen	male
Tiago_Splitter	male
Tian_Liang	male
Tian_Zhuang_Zhuang	male
Tia_Mowry	male
Tiffany_Limos	female
Tiger_Woods	male
Timbul_Silaen	male
Timothy_Coughlin	male
Timothy_Goebel	male
Timothy_McVeigh	male
Timothy_Rigas	male
Timothy_Wirth	male
Tim_Allen	male
Tim_Blake_Nelson	male
Tim_Chapman	male
Tim_Conway	male
Tim_Curley	male
Tim_Curry	male
Tim_Duncan	male
Tim_Floyd	male
Tim_Henman	male
Tim_Howard	male
Tim_Jones	male
Tim_Lobinger	male
Tim_Lopes	male
Tim_Matheson	male
Tim_Norbeck	male
Tim_Pawlenty	male
Tim_Robbins	male
Tim_Salmon	male
Tim_Welsh	male
Tina_Andrews	female
Tina_Brown	female
Tina_Conner	female
Tina_Fey	female
Tina_Pisnik	female
Tina_Sinatra	female
Tino_Martinez	male
Tippi_Hedren	female
Tirunesh_Dibaba	male
TJ_Ford	male
Toby_Keith	male
Tocker_Pudwill	male
Todd_Haynes	male
Todd_MacCulloch	male
Todd_Parrott	male
Todd_Petit	male
Todd_Reid	male
Todd_Robbins	male
Todd_Wike	male
Tomas_Enge	male
Tomas_Malik	male
Tommy_Amaker	male
Tommy_Franks	male
Tommy_Haas	male
Tommy_Lasorda	male
Tommy_Lewis	male
Tommy_Maddox	male
Tommy_Robredo	male
Tommy_Shane_Steiner	male
Tommy_Thompson	male
Tommy_Tubberville	male
Tomoko_Hagiwara	female
Tomomi_Morita	male
Tom_Amstutz	male
Tom_Brady	male
Tom_Brennan	male
Tom_Christerson	male
Tom_Coughlin	male
Tom_Coverdale	male
Tom_Craddick	male
Tom_Crean	male
Tom_Cruise	male
Tom_Curley	male
Tom_Daschle	male
Tom_DeLay	male
Tom_Foy	male
Tom_Gamboa	male
Tom_Glavine	male
Tom_Hanks	male
Tom_Hanusik	male
Tom_Harkin	male
Tom_Izzo	male
Tom_Jones	male
Tom_Kelly	male
Tom_Koenigs	male
Tom_Lantos	male
Tom_McClintock	male
Tom_Miller	male
Tom_Moss	male
Tom_OBrien	male
Tom_Osborne	male
Tom_Poston	male
Tom_Reilly	male
Tom_Ridge	male
Tom_Rouen	male
Tom_Schnackenberg	male
Tom_Scully	male
Tom_Sizemore	male
Tom_Smothers	male
Tom_Tunney	male
Tom_Vilsack	male
Tom_Watson	male
Tom_Welch	male
Tonga	male
Tonino_Guerra	male
Toni_Braxton	female
Toni_Jennings	female
Tono_Suratman	male
Tonya_Payne	female
Tony_Bennett	male
Tony_Blair	male
Tony_Clement	male
Tony_Cummo	male
Tony_Curtis	male
Tony_Elias	male
Tony_Fernandes	male
Tony_LaRussa	male
Tony_Parker	male
Tony_Shalhoub	male
Tony_Stewart	male
Tora_Takagi	male
Tori_Amos	female
Torri_Edwards	male
Toshihiko_Fukui	male
Toshimitsu_Motegi	male
Toshi_Izawa	male
Toutai_Kefu	male
Tracee_Ellis_Ross	female
Tracee_Treadwell	male
Tracy_McGrady	male
Tracy_Wyle	female
Travis_Rudolph	male
Trent_Lott	male
Trevor_McDonald	male
Trevor_Watson	male
Trisha_Meili	female
Tristan_Gretzky	male
Trista_Rehn	female
Troy_Aikman	male
Troy_Garity	male
Troy_Hudson	male
Troy_Jenkins	male
Troy_Polamalu	male
Trudi_Lacey	male
Tsutomu_Takebe	male
Tubby_Smith	male
Tuncay_Sanli	male
Tung_Chee-hwa	male
Turner_Gill	male
Turner_Stevenson	male
Tyler_Grillo	male
Tyler_Hamilton	male
Tyra_Banks	female
Tyrone_Medley	male
Tyron_Garner	male
Ty_Votaw	male
Tzipora_Obziler	male
T_Boone_Pickens	male
Uday_Hussein	male
Ulrich_Kueperkoch	male
Uma_Thurman	male
Uri_Lopolianski	male
Urmila_Matondkar	female
Uthai_Pimchaichon	male
Uzi_Even	male
Uzi_Landau	male
Vaclav_Havel	male
Vaclav_Klaus	male
Vadim_Devyatovskiy	male
Vadim_Strogalev	male
Vagit_Alekperov	male
Valdas_Adamkus	male
Valentina_Cervi	female
Valentina_Tereshkova	female
Valentino_Rossi	male
Valerie_Harper	female
Valerie_Thwaites	female
Valeri_Bure	male
Valery_Giscard_dEstaing	male
Valorie_Brabazon	female
Val_Ackerman	female
Vanessa_Incontrada	female
Vanessa_Laine	female
Vanessa_Redgrave	female
Vanessa_Williams	female
Van_Hilley	male
Vassilis_Xiros	male
Vecdi_Gonul	male
Venus_Williams	female
Vernon_Forrest	male
Veronica_Lake	female
Viara_Vike-Freiberga	female
Vicente_Fernandez	male
Vicente_Fox	male
Vicente_Fox_de_la_Concha	male
Vicki_Zhao_Wei	female
Victoria_Beckham	female
Victoria_Clarke	female
Victor_Garber	male
Victor_Hanescu	male
Victor_Kraatz	male
Vidar_Helgesen	male
Vijay_Nambiar	male
Viktor_Yushchenko	male
Vincent_Brooks	male
Vincent_Cianci_Jr	male
Vincent_Gallo	male
Vincent_Sombrotto	male
Vincent_Spadea	male
Vince_Carter	male
Vince_Dooley	male
Vince_Gill	male
Vince_Vaughan	male
Vinnie_Jones	male
Vin_Diesel	male
Viola_Davis	male
Virgina_Ruano_Pascal	male
Vitali_Klitschko	male
Vivica_Fox	female
Vladimiro_Montesinos	male
Vladimir_Golovlyov	male
Vladimir_Meciar	male
Vladimir_Putin	male
Vladimir_Spidla	male
Vladimir_Ustinov	male
Vladimir_Voltchkov	male
Vojislav_Kostunica	male
Vojislav_Seselj	male
Vyacheslav_Fetisov	male
Vytas_Danelius	male
Walid_Al-Awadi	male
Wallace_Capel	male
Wally_Szczerbiak	male
Walter_Annenberg	male
Walter_Mondale	male
Walter_Woods	male
Walt_Harris	male
Wanda_de_la_Jesus	female
Wanda_Ilene_Barzee	male
Wang_Fei	male
Wang_Hailan	female
Wang_Nan	female
Wang_Yi	male
Wang_Yingfan	male
Wan_Yanhai	male
Ward_Cuff	male
Warren_Beatty	male
Warren_Buffett	male
Warren_Granados	male
Warren_Truss	male
Wayne_Allard	male
Wayne_Brady	male
Wayne_Ferreira	male
Wayne_Gretzky	male
Wayne_Newton	male
Wei_Wu	female
Wendell_Bryant	male
Wendy_Kennedy	female
Wendy_Selig	female
Wen_Ho_Lee	male
Wen_Jiabao	male
Werner_Schlager	male
Wesley_Clark	male
Wes_Craven	male
Whoopi_Goldberg	female
Wilbert_Elki_Meza_Majino	male
Wilbert_Foy	male
Wilfredo_Moreno	male
William_Bratton	male
William_Bulger	male
William_Burns	male
William_Cocksedge	male
William_Delahunt	male
William_Donaldson	male
William_Ford_Jr	male
William_Genego	male
William_Harrison	male
William_Hochul	male
William_Hurt	male
William_Hyde	male
William_Jackson	male
William_Joppy	male
William_Macy	male
William_Martin	male
William_McDonough	male
William_Morrow	male
William_Murabito	male
William_Nessen	male
William_Overlin	male
William_Perry	male
William_Pryor_Jr	male
William_Ragland	male
William_Rehnquist	male
William_Rosenberg	male
William_Shatner	male
William_Swor	male
William_Umbach	male
William_Webster	male
Willie_Nelson	male
Willie_Wilson	male
Willis_Roberts	male
Will_Ferrell	male
Will_Ofenheusle	male
Will_Self	male
Will_Smith	male
Will_Young	male
Wilma_McNabb	male
Wilson_Alvarez	male
Wilton_Gregory	male
Wim_Duisenberg	male
Winona_Ryder	male
Winston_Churchill	male
Win_Aung	male
Wolfgang_Becker	male
Wolfgang_Clement	male
Wolfgang_Schneiderhan	male
Wolfgang_Schuessel	male
Wolfgang_Schwarz	male
Woodrow_Stanley	male
Woody_Allen	male
Wu_Peng	female
Wu_Yi	female
Wycliffe_Grousbeck	male
Xanana_Gusmao	male
Xavier_Malisse	male
Xiang_Huaicheng	male
Xiang_Liu	male
Xiang_Xu	male
Ximena_Bohorquez	female
Yale_Kamisar	male
Yana_Klochkova	female
Yang_Hee_Kim	female
Yang_Jianli	male
Yang_Pao-yu	female
Yannos_Papantoniou	male
Yann_Martel	male
Yao_Ming	male
Yasar_Yakis	male
Yasein_Taher	male
Yashwant_Sinha	male
Yasser_Arafat	male
Yasushi_Akashi	male
Yasushi_Chimura	male
Yekaterina_Guseva	female
Yevgeny_Kafelnikov	male
Yingfan_Wang	male
Yishan_Zhang	male
Yoelbi_Quesada	male
Yogi_Berra	male
Yoko_Ono	male
Yolanda_King	female
Yoon_Jeong_Cho	male
Yoon_Jin-Sik	male
Yoon_Won-Sik	male
Yoon_Young-kwan	male
Yoo_Jay-Kun	male
Yoriko_Kawaguchi	male
Yory_Boy_Campas	male
Yoshiyuki_Kamei	male
Yossi_Beilin	male
Young_Kim	male
Yukiko_Okudo	female
Yukio_Hatoyama	male
Yuri_Fedotov	male
Yuri_Luzhkov	male
Yuri_Malenchenko	male
Yusaku_Miyazato	male
Yusuf_Misbac	male
Yuvraj_Singh	male
Yu_Shyi-kun	male
Yves_Brodeur	male
Zach_Parise	male
Zach_Pillar	male
Zach_Safrin	male
Zafarullah_Khan_Jamali	male
Zahir_Shah	male
Zaini_Abdullah	male
Zakia_Hakki	male
Zalmay_Khalilzad	male
Zarai_Toledo	female
Zara_Akhmadova	female
Zavad_Zarif	male
Zdravko_Mucic	male
Zeljko_Rebraca	male
Zelma_Novelo	female
Zeng_Qinghong	male
Zhang_Wenkang	male
Zhang_Yimou	male
Zhang_Ziyi	female
Zhong_Nanshan	male
Zhu_Rongji	male
Zico	male
Zinedine_Zidane	male
Ziwang_Xu	male
Zoe_Ball	female
Zoran_Djindjic	male
Zorica_Radovic	female
Zulfiqar_Ahmed	male
Zumrati_Juma	male
Zurab_Tsereteli	male
Zydrunas_Ilgauskas	male
